border_size=1
usage=map

Gg          , Gg          , Ss^Fmw      , Ss          , Gs^Fdw      , Gg          , Gg          , Gg          , Xu          , Gg          , Ss^Fmw      , Ss          , Ss^Fmw      , Gg          , Gg          , Gg          , Xu          , Gs          , Re          , Ss          , Ss          , Ss          , Ss          , Ss          , Gs^Fdw      , Gg          
Gg          , Ss          , Ss^Fmw      , Ss^Fdw      , Ce          , Ss^Fmw      , Ss^Fmw      , Gg          , Xu          , Ur          , Gg          , Ss^Fmw      , Ce          , Ss          , Ss          , Ss^Fmw      , Xu          , Ss^Fmw      , Ss^Fmw      , Ss^Fmw      , Ce          , Gs^Fmw      , Gs^Fmw      , Gs^Fmw      , Ss^Fdw      , Ss^Fmw      
Re          , Gs^Fp       , Gs^Uf       , Ce          , Ce          , Ce          , Ce          , Ss^Fms      , Xu          , Gs^Fmw      , Ss          , Ce          , Ce          , Ce          , Ce          , Ss^Fmw      , Xu          , Ss^Fmw      , Ss^Fdw      , Ce          , Ce          , Ce          , Ce          , Ss          , Ss          , Ss^Fmw      
Ww          , Re          , Ss^Bw\      , Ce          , Ce          , 1 Ke        , Ss          , Ss          , Xu          , Gs^Fmw      , Re          , Ce          , Ce          , 3 Ke        , Ur          , Gg          , Xu          , Gs^Fdw      , Ss^Fdw      , Ce          , Ce          , 2 Ke        , Re          , Ww          , Re          , Ss^Fmw      
Ss^Fmw      , Ww          , Ww          , Re          , Re          , Ss          , Gs^Fmw      , Gs^Fmw      , Xu          , Gs^Fmw      , Ss          , Ss^Fmw      , Gg          , Ss^Fmw      , Re          , Gs^Fmw      , Xu          , Ss          , Gg^Vc       , Ss^Fmw      , Ss^Fmw      , Ur          , Ss          , Ww          , Rd          , Rd          
Ss^Fmw      , Ss^Fmw      , Ss          , Ww          , Re          , Gs^Fmw      , Ss          , Gs^Fp       , Xu          , Ss^Fms      , Ur          , Ss          , Ur          , Gg          , Gg^Vh       , Ss          , Xu          , Gs^Fmw      , Ss          , Ss          , Ur          , Ss^Fms      , Ss^Bw/      , Ww^Bw/      , Ww          , Ss          
Gs^Fdw      , Ss^Fdw      , Ww          , Ww          , Gs^Fmw      , Re          , Re          , Gs^Fmw      , Xu          , Uu^Uf       , Re          , Re          , Re          , Re          , Re          , Ss          , Xu          , Ss          , Ss          , Ss^Fmw      , Re          , Re          , Ss          , Ww          , Ww          , Gs^Fdw      
Gs^Fp       , Ww          , Ss^Fmw      , Ss^Vhs      , Ur          , Re          , Ss^Fmw      , Re          , Xu          , Re          , Gs^Uf       , Ss          , Ss^Fms      , Ss          , Gs^Fmw      , Re          , Xu          , Ss^Fmw      , Re          , Re          , Gs^Uf       , Ss          , Uu^Uf       , Ss          , Ww          , Ss          
Gs^Fmw      , Ww          , Uu^Uf       , Ss^Fmw      , Ss^Fdw      , Ss^Fmw      , Ss^Fmw      , Ss^Fmw      , Xu          , Ss          , Uu^Uf       , Gs^Fmw      , Gs^Fmw      , Ss          , Gs^Fmw      , Gs^Uf       , Xu          , Re          , Gs          , Gs^Fmw      , Ss          , Uu^Uf       , Ss          , Ss          , Gs^Fmw      , Ww          
Ww          , Ww          , Ww          , Ss          , Ss          , Ss^Fmw      , Re          , Gs          , Xu          , Ss          , Ss          , Gs          , Re          , Ss          , Ss          , Gs^Fp       , Xu          , Gs          , Ss^Fmw      , Re          , Ss^Fmw      , Ss          , Gs^Fmw      , Ss          , Ss          , Gs^Fmw      
Ww          , Ss          , Re          , Gs^Fmw      , Gs^Fmw      , Gs^Fmw      , Ss          , Gs^Fmw      , Xu          , Gs^Fmw      , Ss          , Ss^Fmw      , Ss^Fmw      , Ss^Fmw      , Re          , Gs^Fmw      , Xu          , Gs^Fmw      , Ss^Fmw      , Ss^Fmw      , Ss          , Re          , Gs^Fmw      , Gs^Fmw      , Ss          , Gs^Fmw      
Ss^Fdw      , Ss          , Ss          , Gs^Fmw      , Ss          , Ss          , Uu^Uf       , Gs^Uf       , Xu          , Ss          , Hh^Fp       , Ss^Fmw      , Hh^Fp       , Hh^Fp       , Mm          , Gs^Fmw      , Xu          , Ss          , Hh^Fp       , Ss^Fdw      , Hh^Fp       , Hh^Fp       , Mm          , Uu^Vud      , Uu^Uf       , Ss          
Ss^Fdw      , Ww          , Ss^Vm       , Gs^Fmw      , Re          , Ss^Fms      , Hh^Fp       , Gs^Fmw      , Xu          , Ss^Fmw      , Ss^Fdw      , Hh^Fp       , Gs^Fmw      , Ss^Vhs      , Mm          , Re          , Xu          , Ss          , Gg          , Hh^Fp       , Ss^Fmw      , Gg          , Mm          , Ss          , Ww          , Ww          
Ss^Fmw      , Ss          , Ss^Fmw      , Hh^Fp       , Hh^Fp       , Hh^Fp       , Gs^Fmw      , Mm          , Xu          , Ss^Fms      , Ss^Fdw      , Ss          , Gg          , Gg          , Gs^Fmw      , Gs^Fmw      , Xu          , Ss^Fmw      , Hh^Fp       , Ss^Fmw      , Gg          , Hh^Fp       , Gg          , Ss^Fmw      , Ww          , Gs^Fmw      
Ww          , Ss          , Hh^Fp       , Ss^Fdw      , Ss^Fmw      , Ss^Fmw      , Gs^Vht      , Mm          , Xu          , Re          , Gg          , Ss          , Ss          , Re          , Ur          , Ss          , Xu          , Ss^Fmw      , Ss^Fmw      , Gg          , Re          , Gs          , Gg          , Ur          , Ww          , Ss          
Ur          , Ww          , Ww          , Ss          , Ss^Fmw      , Ww          , Gs^Fmw      , Gs^Uf       , Xu          , Ur          , Ss          , Gs^Fmw      , Gs^Fmw      , Gs^Fmw      , Gg          , Ss^Fmw      , Xu          , Gs^Fp       , Gg^Vc       , Ss^Fmw      , Ss          , Gs^Fmw      , Ss          , Ss^Fms      , Ww          , Gs^Fmw      
Gs          , Gs^Fmw      , Ss          , Uu^Uf       , Ss          , Ss          , Gs^Uf       , Gs^Fp       , Xu          , Ss          , Ss          , Gs^Fmw      , Ss          , Ss          , Hh^Fp       , Ss^Fmw      , Xu          , Gs^Fmw      , Ss          , Uu^Uf       , Hh          , Gs^Fmw      , Gs^Fmw      , Ss          , Ww          , Ur          
Ss^Fmw      , Re          , Ss          , Ss          , Gs^Fmw      , Ss          , Gs^Fmw      , Ss^Fmw      , Xu          , Ss^Fms      , Ww          , Ss^Fmw      , Ss^Fdw      , Gs^Fdw      , Ss^Fmw      , Ss^Fdw      , Xu          , Re          , Ss^Fmw      , Ss          , Gs^Fmw      , Ss          , Hh          , Gs^Fmw      , Ss          , Ww          
Ss^Fmw      , Ss^Fmw      , Ss          , Re          , Gs^Fmw      , Gs^Fmw      , Ce          , Gs          , Gs^Fmw      , Ww          , Gs^Fmw      , Ur          , Ss^Fmw      , Ce          , Ce          , Ss^Fmw      , Ss^Fmw      , Ss^Fmw      , Ss          , Re          , Ce          , Ss          , Ce          , Re          , Ss          , Hh^Fp       
Gs^Fdw      , Ss^Fdw      , Hh^Fp       , Ss          , Ce          , Ce          , Ce          , Re          , Ss          , Ww          , Ss          , Ss^Vhs      , Ss^Fmw      , Ce          , 5 Ke        , Re          , Gs^Fdw      , Ss^Fdw      , Hh^Fp       , Ce          , Ce          , 6 Ke        , Ce          , Ss^Fmw      , Ss          , Gs^Fmw      
Ss          , Ss^Fdw      , Ss^Fmw      , Ce          , Ce          , 4 Ke        , Ss          , Ss^Fmw      , Ss          , Uu^Uf       , Ss          , Hh^Fp       , Gs^Fmw      , Ce          , Ce          , Ce          , Ur          , Ss^Fdw      , Ss^Fmw      , Ss^Vhs      , Ur          , Ce          , Ce          , Ss          , Gs^Fmw      , Gs^Fmw      
Gg          , Ss^Fmw      , Ss^Fmw      , Ss          , Gs^Fdw      , Ce          , Ss          , Re          , Ss^Fmw      , Ss          , Ss^Fmw      , Ss^Fdw      , Ss          , Ce          , Gs^Fmw      , Gs^Fmw      , Ss^Vm       , Ss^Fmw      , Ss          , Gs^Fmw      , Ss          , Gs^Uf       , Ss          , Ss          , Re          , Gs^Fmw      
Gg          , Ss          , Ss^Fmw      , Ss^Fdw      , Ss^Fdw      , Ss^Fmw      , Re          , Ur          , Gg          , Ss^Fmw      , Ss^Fdw      , Ss          , Ss          , Gs^Fmw      , Re          , Ss          , Uu^Uf       , Ss          , Gs^Fmw      , Gs^Fmw      , Ss          , Ss^Fms      , Re          , Ww          , Ss          , Ss          
Gg          , Ss^Fmw      , Uu^Vud      , Hh^Fp       , Ww          , Ww          , Ss          , Gs^Fmw      , Ss          , Hh^Fp       , Ss^Fdw      , Gs^Fdw      , Uu^Uf       , Ss          , Ss          , Ss^Fms      , Re          , Ss          , Re          , Gs^Fmw      , Gs^Fmw      , Re          , Ss^Fmw      , Ss^Fmw      , Ss          , Ss^Fmw      
Gs^Fp       , Ur          , Gs^Fmw      , Ss          , Ww          , Ss          , Ur          , Ss^Fmw      , Ss^Fmw      , Ss^Fmw      , Ss          , Ss^Fmw      , Gs^Uf       , Gs^Fmw      , Gs^Fmw      , Ss          , Gs^Fmw      , Ur          , Ss^Fmw      , Gs^Fp       , Gs^Uf       , Ur          , Gg          , Ss          , Ss^Fdw      , Ss^Fdw      
Gs^Fmw      , Gs^Uf       , Uu^Uf       , Gs^Fmw      , Ww          , Re          , Gs^Fmw      , Gg          , Hh^Fp       , Ss^Fdw      , Gs^Fdw      , Ss^Fmw      , Ss^Fmw      , Gs          , Gs^Fmw      , Gs^Fp       , Ss          , Gg^Vc       , Gs          , Gs^Fmw      , Ss          , Uu^Uf       , Ss          , Ss^Fmw      , Ss^Fmw      , Ss          
Re          , Ss          , Ss          , Ss          , Ww          , Ss          , Ss          , Ss          , Ss          , Ss^Fdw      , Gs^Fdw      , Ss^Fmw      , Ss^Fmw      , Re          , Ss          , Gs^Uf       , Ss          , Hh^Fp       , Ss^Fmw      , Re          , Ss          , Ss          , Gs^Fmw      , Ss          , Gs^Fmw      , Gs^Fmw      
Ss^Fmw      , Ss^Fmw      , Ww          , Ww          , Gs^Fmw      , Gs^Fmw      , Gs^Fmw      , Re          , Ss^Fmw      , Ss          , Ss^Fdw      , Ss^Fdw      , Ss          , Ss^Fmw      , Ss          , Uu^Uf       , Gs^Uf       , Uu^Uf       , Ss^Fmw      , Ss^Fmw      , Ss          , Re          , Gs^Fmw      , Gs^Fmw      , Ss          , Uu^Uf       
Ss^Fdw      , Ss          , Ww          , Gs          , Gs^Fmw      , Gs^Fp       , Ss          , Ss          , Ss          , Ss^Fmw      , Ss^Fmw      , Hh^Fp       , Ss          , Re          , Co          , Gs^Fp       , Gs^Fmw      , Ss          , Gs^Fdw      , Ss^Fdw      , Ww          , Ss          , Gs^Fmw      , Ss          , Ss^Fms      , Ss          
Ww          , Ww          , Ss^Fmw      , Re          , Ss          , Gs^Uf       , Ss^Fmw      , Ss          , Ss^Fmw      , Ss          , Ss^Fmw      , Ss^Vhs      , Co          , Co          , Co          , Co          , Gs          , Re          , Ss          , Ww          , Ss^Fmw      , Ww          , Ww          , Ww          , Ww          , Ww          
Gs^Fp       , Ss^Fdw      , Ss          , Ss^Fmw      , Re          , Ur          , Gg          , Ss^Fmw      , Ss^Fdw      , Ss          , Gs          , Ur          , Co          , Co          , Co          , Co          , Ur          , Ss^Fmw      , Ss^Fmw      , Ss^Fmw      , Gs          , Gs^Fmw      , Ss          , Uu^Uf       , Ss          , Ss^Fmw      
Gs^Fmw      , Gs^Uf       , Uu^Uf       , Ss^Fms      , Ss          , Gs^Fmw      , Ss          , Hh^Fp       , Ss^Fdw      , Gs^Fdw      , Ss^Fmw      , Ss^Fmw      , Co          , 7 Ko        , Co          , Co          , Uu^Vu       , Ss^Fmw      , Uu^Uf       , Ss          , Ss^Fmw      , Re          , Ss^Fmw      , Ss          , Gs^Fmw      , Ss          
Re          , Ss          , Ss          , Ss          , Ss          , Gs^Fmw      , Re          , Ss          , Ss^Fmw      , Ss^Fmw      , Ss^Fmw      , Ss^Fmw      , Ss          , Co          , Re          , Ss          , Gs^Fp       , Gs^Uf       , Ss          , Ss          , Ss^Fmw      , Ss^Fmw      , Ss          , Re          , Gs^Fmw      , Gs^Fmw      
Ss^Fmw      , Ss^Fmw      , Re          , Gs^Fmw      , Gs^Fmw      , Gs^Fmw      , Ss          , Ss^Fmw      , Re          , Ss^Fmw      , Ss^Fmw      , Re          , Uu^Uf       , Ss          , Ss^Fmw      , Ss          , Ss^Fdw      , Gs^Fmw      , Re          , Ss^Fmw      , Gs^Fdw      , Ss^Fdw      , Hh^Fp       , Ss          , Gs^Fmw      , Ss          
Ss^Fdw      , Ss          , Ss          , Gs^Fmw      , Ss          , Ss          , Uu^Uf       , Ss          , Gs^Fmw      , Gs          , Ss          , Ss          , Gs^Uf       , Ss          , Re          , Ss^Fmw      , Ss^Fmw      , Gs          , Ss^Fmw      , Ss^Fmw      , Ss          , Ss^Fdw      , Ss^Fmw      , Gg          , Ur          , Re          
Ss^Fdw      , Hh^Fp       , Ss^Vhs      , Gs^Fmw      , Re          , Ss^Fms      , Ss^Fms      , Gs^Uf       , Gs^Fp       , Gs^Fmw      , Ss          , Uu^Uf       , Gs^Fp       , Gs^Fmw      , Gs          , Ss^Fmw      , Gg          , Gg          , Gg          , Ss^Fmw      , Gs^Fdw      , Ss^Fmw      , Ss          , Ss^Fmw      , Gg          , Gg          
