border_size=1
usage=map

Mm          , Mm          , Mm          , Mm          , Mm          , Mm          , Mm          , Mm          , Mm          , Mm          , Mm          , Mm          , Mm          , Mm          , Mm          , Mm          , Hh          , Hh          , Xu          , Xu          , Ww          , Ww          , Ww          , Uu          , Uu          , Uu          , Uu          
Mm          , Mm          , Gg          , Gg          , Mm          , Mm          , Hh^Fp       , Mm          , Mm          , Mm          , Mm          , Mm          , Mm          , Mm          , Mm^Xm       , Mm          , Hh          , Xu          , Uh          , Ww          , Cud         , Cud         , Cud         , Ww          , Ww          , Uu^Uf       , Ww          
Mm          , Gg          , Gg          , Mm          , Mm          , Mm          , Mm          , Hh^Fp       , Gg          , Gg          , Gg          , Mm          , Mm          , Mm^Xm       , Mm          , Mm          , Hh          , Xu          , Uu^Vu       , Ww          , Cud         , 4 Kud       , Cud         , Uu^Vud      , Uu          , Ww          , Ur          
Mm          , Gg          , Gg          , Gg          , Mm          , Hh^Fp       , Hh^Fp       , Mm          , Mm          , Gg          , Gg          , Gg          , Mm          , Mm          , Mm^Xm       , Mm          , Xu          , Xu          , Xu          , Ww          , Uh          , Cud         , Ur          , Ur          , Ur          , Ur          , Gg          
Mm          , Mm          , Mm          , Gg          , Mm          , Mm          , Mm          , Mm          , Hh          , Mm          , Hh          , Mm          , Mm          , Mm          , Mm          , Xu          , Wwf         , Ww          , Ww          , Ur          , Ur          , Ur          , Cud         , Cud         , Cud         , Uu^Vud      , Uu          
Mm          , Mm          , Gg          , Mm          , Mm          , Mm          , Hh^Fp       , Mm          , Mm          , Mm          , Mm          , Mm          , Mm          , Gg          , Gg          , Xu          , Cud         , Uu          , Uu          , Uu          , Uh          , Uu          , Cud         , 5 Kud       , Cud         , Uu          , Uu          
Mm          , Gg          , Gg          , Mm          , Gg          , Mm          , Hh^Fp       , Mm^Xm       , Mm          , Hh^Fp       , Mm          , Mm          , Mm          , Gg          , Mm          , Hh          , Re          , Xu          , Xu          , Xu          , Xu          , Uu^Uf       , Uu^Vud      , Cud         , Uu          , Uu          , Xu          
Mm          , Mm          , Mm          , Hh^Fdw      , Mm          , Hh^Fp       , Mm          , Mm          , Mm          , Mm          , Hh^Fp       , Mm          , Mm          , Mm          , Mm          , Re          , Gg          , Gg          , Mm          , Ms          , Ms          , Xu          , Xu          , Uu          , Xu          , Xu          , Mm          
Mm          , Mm          , Mm          , Gg          , Mm          , Mm          , Mm          , Mm^Xm       , Mm          , Gg          , Gg          , Mm          , Mm          , Mm          , Re          , Re          , Ha^Fpa      , Ms          , Mm          , Ms          , Mm          , Ms          , Mm          , Xu          , Mm          , Mm^Vc       , Mm          
Mm          , Hh^Fdw      , Hh          , Gg          , Mm          , Mm          , Mm          , Gg          , Gg          , Gg          , Gg          , Hh^Fp       , Hh          , Ha          , Re          , Ha^Fpa      , Gg          , Ms          , Mm          , Mm          , Mm          , Mm^Xm       , Mm          , Mm          , Mm          , Mm          , Mm          
Mm          , Hh          , Hh          , Gg          , Mm          , Mm          , Gg          , Mm          , Mm          , Gg          , Mm          , Mm          , Hh          , Re          , Ms          , Gg          , Gg          , Mm          , Mm          , Mm          , Mm          , Mm          , Gg          , Mm          , Mm          , Mm          , Mm          
Mm          , Mm          , Mm          , Mm          , Mm          , Gg          , Gg          , Gg          , Mm          , Mm          , Mm          , Hh          , Mm          , Re          , Ms          , Ms          , Gs^Fdw      , Hh^Fp       , Mm          , Mm          , Gg          , Gs^Fdw      , Mm          , Gg          , Mm          , Gg          , Mm          
Mm          , Mm          , Mm          , Mm          , Mm          , Mm          , Gg          , Gg          , Mm          , Mm          , Mm          , Mm          , Mm          , Re          , Ms          , Gg          , Ms          , Hh^Fp       , Mm          , Gg          , Gs^Fmf      , Mm          , Mm^Vc       , Mm          , Gg          , Gg          , Mm          
Mm          , Mm          , Ce          , Ce          , Ce          , Mm          , Mm          , Mm          , Gg          , Mm          , Mm          , Mm          , Re          , Re          , Mm          , Mm          , Gg          , Gg          , Mm          , Mm          , Gg          , Mm          , Hh          , Mm          , Hh          , Mm          , Mm          
Mm          , Mm          , Ce          , 6 Ke        , Ce          , Mm          , Mm          , Hh^Fdw      , Hh^Fdw      , Gg          , Gg          , Hh^Fp       , Gg          , Re          , Mm          , Mm          , Gg          , Mm          , Mm          , Mm          , Gg          , Gs^Fmf      , Mm          , Hh          , Mm          , Gs^Fdw      , Mm          
Mm          , Gs^Fdw      , Gs^Fdw      , Ce          , Gs^Fds      , Gg          , Ce          , Mm          , Mm          , Mm          , Gs^Fdw      , Gg          , Hh^Fp       , Re          , Mm          , Gg          , Re          , Gg          , Mm          , Mm          , Mm          , Gg          , Gg          , Mm          , Mm          , Mm          , Mm          
Mm          , Mm          , Ce          , Mm          , Gs^Fds      , Ce          , 7 Ke        , Ce          , Gg          , Ms          , Ww          , Gg          , Mm          , Re          , Re          , Mm          , Gg          , Mm          , Mm          , Mm          , Mm          , Gg          , Hh^Fp       , Mm          , Mm          , Mm          , Gs^Fmf      
Mm          , Ce          , 9 Ke        , Ce          , Gg          , Ce          , Ce          , Ce          , Ww          , Ww          , Ms          , Ww          , Ms          , Gg          , Re          , Gs^Vht      , Re          , Gg          , Gg          , Mm          , Hh^Fdw      , Mm          , Mm          , Mm          , Mm          , Mm          , Mm          
Mm          , Ce          , Ce          , Ce          , Mm          , Mm          , Ww          , Ww^Bw\      , Ce          , Mm          , Mm          , Ww          , Gg          , Mm          , Re          , Gg          , Gs^Fdw      , Gg          , Gg^Ve       , Gg          , Mm          , Mm          , Mm          , Mm          , Gg^Vh       , Mm          , Mm          
Ww          , Ww          , Ww          , Ww          , Ww          , Ww          , Ww          , Ce          , 8 Ke        , Ce          , Mm          , Ww          , Re          , Re          , Gs^Fdw      , Gg          , Mm          , Gg          , Mm          , Mm          , Mm          , Gs^Fmf      , Mm          , Mm          , Mm          , Mm          , Mm          
Mm          , Mm          , Mm          , Mm          , Mm          , Mm          , Ww^Bw/      , Ce          , Ce          , Ce          , Ww          , Wwf         , Gg          , Gg          , Mm          , Gs^Fds      , Gg          , Mm          , Mm          , Mm          , Mm          , Hh^Fp       , Mm          , Mm          , Gs^Fmf      , Mm          , Mm          
Mm          , Mm          , Mm          , Mm          , Gg          , Gg          , Mm          , Ww          , Ww          , Ww          , Mm          , Re          , Mm          , Hh          , Mm          , Mm          , Gs^Fdw      , Mm          , Gs^Fmf      , Mm          , Mm          , Gs^Fmf      , Mm          , Mm          , Mm          , Mm          , Mm          
Mm          , Mm          , Mm^Vc       , Mm          , Mm          , Gg          , Mm          , Ww          , Ww          , Mm          , Ha^Vca      , Re          , Re          , Gs^Fdw      , Hh          , Mm          , Mm          , Gg          , Mm          , Mm          , Mm          , Mm          , Mm          , Mm          , Gs          , Mm          , Mm          
Mm          , Mm          , Mm          , Mm          , Mm          , Mm          , Re^Gvs      , Re^Gvs      , Re^Gvs      , Ww          , Ww          , Mm          , Mm          , Re          , Hh          , Mm          , Mm          , Gg          , Mm          , Mm          , Gg^Vh       , Mm          , Mm          , Mm          , Gs          , Mm          , Mm          
Mm          , Mm          , Mm          , Hh^Fp       , Mm          , Hh^Fds      , Gg^Vh       , Ww          , Gg^Wm       , Mm          , Ww          , Gg          , Mm          , Re          , Re          , Gs^Fdw      , Gs^Fds      , Gg          , Mm          , Gs          , Gs          , Hh^Fdw      , Mm          , Mm          , Gs          , Gg          , Mm          
Mm          , Mm          , Gg          , Gg          , Mm          , Hh^Fds      , Hh^Fds      , Re^Gvs      , Mm          , Mm          , Ww          , Gs^Fdw      , Gg          , Mm          , Re          , Gg          , Mm          , Gg          , Mm          , Gg          , Gg          , Hh^Fdw      , Gs^Vht      , Mm          , Mm          , Gg          , Mm          
Mm          , Gg          , Mm          , Hh^Fp       , Gs^Fdw      , Mm          , Mm          , Mm          , Gs^Fdw      , Mm          , Ww          , Ww          , Mm          , Gg          , Mm          , Re          , Re          , Gg          , Gs^Fds      , Mm          , Mm          , Mm          , Mm          , Mm^Xm       , Mm^Xm       , Mm          , Mm          
Mm          , Gg          , Mm          , Mm          , Mm          , Gs^Fmf      , Mm          , Mm          , Gg          , Gg          , Ww          , Hh^Fdw      , Mm          , Mm          , Gs^Fdw      , Mm          , Mm          , Re          , Mm          , Mm          , Mm          , Mm          , Mm          , Mm          , Mm          , Mm^Xm       , Mm^Xm       
Mm          , Mm          , Mm          , Mm          , Gs^Fmf      , Hh          , Hh^Fdf      , Gg          , Mm          , Mm^Xm       , Ww          , Hh^Fdw      , Gg          , Gg          , Mm          , Hh^Fdf      , Hh^Fmw      , Re          , Hh^Fmw      , Gs^Fp       , Mm^Vc       , Mm          , Mm          , Gg          , Mm^Xm       , Mm          , Mm          
Mm          , Mm          , Mm          , Gs^Fdw      , Gg          , Mm          , Mm          , Hh          , Mm          , Hh          , Ww          , Mm          , Gg          , Mm          , Hh^Fdf      , Mm          , Hh^Fmw      , Re          , Hh^Fmw      , Mm          , Mm          , Gg          , Mm          , Gg          , Mm          , Mm          , Mm          
Mm          , Mm          , Mm          , Mm          , Mm          , Mm          , Mm          , Mm          , Ww          , Ww          , Mm          , Hh^Fdf      , Mm          , Ms          , Gg          , Ha^Vhha     , Mm          , Re          , Mm^Xm       , Mm^Xm       , Gg          , Gg          , Mm          , Mm          , Mm^Xm       , Mm          , Mm          
Mm          , Mm          , Mm          , Mm^Xm       , Mm          , Mm          , Mm          , Gg          , Ww          , Mm          , Gg          , Hh^Fdf      , Gg          , Mm          , Gg          , Mm          , Re          , Re          , Mm          , Mm          , Mm          , Hh^Fp       , Mm          , Gg          , Mm          , Mm          , Mm          
Mm          , Mm^Xm       , Mm^Xm       , Mm^Xm       , Mm^Xm       , Mm          , Mm^Xm       , Mm          , Ww          , Mm          , Gg          , Mm          , Mm          , Mm          , Ms          , Gg          , Re          , Ms          , Mm          , Mm          , Mm          , Hh^Fp       , Mm          , Gg          , Mm          , Mm          , Mm          
Mm^Xm       , Mm^Xm       , Mm^Xm       , Mm^Xm       , Gs^Fp       , Gs^Fp       , Hh^Fp       , Hh^Fp       , Mm          , Ww          , Ha^Fma      , Gg          , Mm          , Mm          , Gg          , Re          , Ms          , Gg          , Mm          , Gg          , Gg          , Hh^Fp       , Hh^Fp       , Mm          , Mm^Xm       , Mm          , Mm          
Mm^Xm       , Mm^Xm       , Mm^Xm       , Mm^Xm       , Mm^Xm       , Gs^Fp       , Hh^Fp       , Hh^Fp       , Ww          , Ww          , Ha          , Ha          , Mm          , Mm^Vc       , Re          , Re          , Mm          , Gg          , Mm          , Hh          , Mm          , Gg          , Mm          , Hh^Fp       , Mm          , Mm          , Mm          
Mm^Xm       , Mm^Xm       , Mm^Xm       , Mm^Xm       , Mm^Xm       , Mm          , Hh^Fdw      , Gg          , Ww          , Mm          , Mm          , Ha          , Mm          , Mm          , Re          , Hh^Fp       , Hh^Fp       , Mm          , Hh          , Hh          , Mm          , Gg          , Mm          , Mm          , Mm^Vc       , Mm          , Mm          
Mm^Xm       , Mm^Xm       , Mm^Xm       , Mm^Xm       , Ms          , Ms          , Ms          , Gg          , Ww          , Mm          , Ce          , Ce          , Ce          , Re          , Mm          , Hh^Fp       , Mm          , Ha          , Hh          , Ha^Fma      , Mm          , Mm          , Mm          , Mm          , Mm          , Mm          , Mm          
Mm^Xm       , Mm^Xm       , Hh^Fdw      , Mm^Xm       , Ms          , Mm          , Hh^Fdw      , Mm          , Ww          , Mm          , Ce          , 1 Ke        , Ce          , Mm          , Mm          , Mm          , Ha^Fma      , Hh          , Hh          , Hh          , Gg          , Gg          , Hh^Fp       , Mm          , Mm          , Mm          , Mm          
Mm^Xm       , Mm^Xm       , Mm          , Mm          , Mm          , Mm^Xm       , Mm          , Gg^Vc       , Ww          , Mm          , Mm          , Ce          , Gg          , Hh^Fdf      , Ha^Fma      , Ha^Vca      , Ha^Fma      , Hh^Fdf      , Mm          , Mm^Xm       , Mm          , Hh^Fp       , Mm          , Mm          , Gg          , Gg          , Mm          
Mm          , Mm          , Mm          , Mm          , Mm          , Mm          , Ww          , Ww          , Mm          , Ss          , Wwf         , Mm          , Ha          , Gg          , Ce          , Hh          , Hh          , Ha          , Hh^Fmw      , Mm          , Mm          , Mm          , Mm          , Mm          , Mm          , Mm          , Hh          
Mm          , Mm          , Mm          , Mm          , Mm          , Ww          , Mm^Vc       , Mm          , Gg          , Gg          , Gg          , Wwf         , Ww          , Ce          , 3 Ke        , Ce          , Hh^Fds      , Hh^Fmw      , Hh^Fds      , Hh^Fmw      , Hh^Fmw      , Hh^Fmw      , Hh^Fmw      , Mm          , Gg          , Hh          , Hh          
Hh          , Mm          , Hh          , Mm          , Mm          , Ww          , Ce          , Ce          , Ce          , Hh^Fp       , Gg          , Hh^Fds      , Hh          , Ce          , Ce          , Ce          , Hh^Fds      , Hh^Fds      , Hh^Fds      , Hh^Fmw      , Hh          , Hh^Fmw      , Gg          , Gg          , Gg          , Hh          , Hh          
Hh          , Hh          , Gg          , Gg          , Ww          , Ww          , Ce          , 2 Ke        , Ce          , Hh^Fds      , Hh^Fp       , Gg          , Hh^Fp       , Hh          , Hh^Fds      , Hh^Fds      , Hh^Fds      , Gg          , Gg          , Hh          , Gg          , Hh          , Gg          , Gg          , Hh          , Hh          , Hh          
Ww          , Ww          , Ww          , Ww          , Ww          , Ww          , Hh          , Ce          , Hh^Fp       , Hh^Fds      , Gg          , Gg          , Gs^Fds      , Hh          , Gg          , Hh^Fds      , Gs^Fds      , Hh^Fds      , Gg          , Gg          , Gg          , Gg          , Gg          , Gg          , Gg          , Gg          , Gg          
Hh          , Hh          , Hh          , Hh          , Hh          , Hh          , Gg          , Hh          , Gg          , Gg          , Gg          , Gs^Fds      , Gs^Fds      , Gg          , Rd          , Gs^Fmf      , Gs^Fmf      , Gs^Fds      , Gs^Fds      , Gg          , Gs^Fds      , Gg          , Gg          , Gg          , Gg          , Gg          , Gg          
Gg          , Gg          , Gg          , Gg          , Gs^Fds      , Gs^Fds      , Gg          , Gg          , Gg          , Gs^Fds      , Gs^Fds      , Gg          , Gs^Fds      , Rd          , Gg^Vh       , Rd          , Gs^Fds      , Gs^Fds      , Gs^Fds      , Gs^Fmf      , Gs^Fmf      , Gs^Fds      , Gs^Fds      , Gg          , Gg          , Gg          , Gg          
Gg          , Gg          , Gs^Fds      , Ss          , Gs^Fds      , Gs^Fds      , Gs^Fds      , Rd          , Rd          , Ss          , Gs^Fds      , Hh^Fds      , Gs^Fds      , Rd          , Gs^Fmf      , Gs^Fds      , Hh^Fds      , Gs^Fdf      , Hh          , Rd          , Gs^Fds      , Gs^Fds      , Gs^Fds      , Gg          , Gg          , Gg          , Gg          
Gg          , Rd          , Hh          , Gs^Fds      , Hh^Fds      , Gg          , Gs^Fds      , Gs^Fds      , Rd          , Gs^Fds      , Hh          , Gs^Fdf      , Gs^Fds      , Gs^Fmf      , Gs^Fds      , Gg          , Gs^Fds      , Gs^Fds      , Gs^Fds      , Gs^Fds      , Gs^Fmf      , Gs^Fds      , Gs^Fdf      , Hh          , Gs^Fds      , Gg          , Gg          
Gg          , Gg          , Gs^Fds      , Gs^Fdf      , Gs^Fds      , Gs^Fds      , Rd          , Gs^Fmf      , Gs^Fmf      , Gs^Fds      , Gs^Fdf      , Gs^Fds      , Gs^Fds      , Gs^Fds      , Gs^Fds      , Gs^Fds      , Gg          , Ss          , Gs^Fds      , Gs^Fmf      , Rd          , Gs^Fds      , Hh^Fds      , Gs^Fds      , Ss          , Gg          , Gg          
Gg          , Gs^Fds      , Gs^Fds      , Gs^Fds      , Gs^Fmf      , Rd          , Gg^Vh       , Rd          , Gs^Fds      , Gs^Fds      , Gs^Fds      , Hh          , Gs^Fds      , Gs^Fdf      , Gs^Fds      , Gs^Fds      , Gg          , Gg          , Gg          , Gg^Vh       , Rd          , Gs^Fds      , Gg          , Gs^Fds      , Gg          , Gg          , Gg          
Gg          , Gg          , Gg          , Gs^Fds      , Gs^Fds      , Gs^Fmf      , Gg          , Gg          , Gg          , Gs^Fds      , Gg          , Ss          , Gs^Fds      , Hh          , Gg          , Gg          , Gg          , Gg          , Gg          , Rd          , Gg          , Gs^Fds      , Gs^Fds      , Gg          , Gg          , Gg          , Gg          
Gg          , Gg          , Gg          , Gg          , Gg          , Gg          , Gg          , Gg          , Gg          , Gg          , Gg          , Gg          , Gg          , Gg          , Gg          , Gg          , Gg          , Gg          , Gg          , Gg          , Gg          , Gs^Fds      , Gg          , Gg          , Gg          , Gg          , Gg          
