border_size=1
usage=map

Gs^Fp       , Gs^Fp       , Gs^Fp       , Gs^Fp       , Gs^Fp       , Gs^Fp       , Gs^Fp       , Gs^Fp       , Ss          , Gs^Fp       , Gs^Fp       , Gs^Fp       , Gs^Fp       , Gs^Fp       , Gs^Fp       , Gs^Fp       , Gs^Fp       , Gs^Fp       , Ss          , Gs^Fp       , Gs^Fp       , Gs^Fp       , Ss          , Re          , Gs^Fp       , Gs^Fp       , Gs^Fp       , Gs^Fp       , Gs^Fp       , Gs^Fp       , Gs^Fp       , Gs^Fp       , Gs^Fp       , Gs^Fp       , Gs^Fp       , Gs^Fp       , Gs^Fp       , Gs^Fp       , Gs^Fp       , Gs^Fp       , Gs^Fp       , Gs^Fp       , Gs^Fp       , Gs^Fp       , Gs^Fp       , Gs^Fp       
Gs^Fp       , Ss          , Hh^Fp       , Gs^Fp       , Gg          , Gg          , Gg          , Gs^Fp       , Gs^Fp       , Gs^Fp       , Gs^Fp       , Gs^Fp       , Gs^Fp       , Gs^Fp       , Ss          , Ss          , Re          , Gs^Fp       , Gg          , Gs^Fp       , Ss          , Gs^Fp       , Ss          , Re          , Gs^Fp       , Ss          , Gg          , Ss          , Gs^Fp       , Gg          , Re          , Gg          , Gg          , Gs^Fp       , Ss          , Gs^Fp       , Ss          , Gg          , Gs^Fp       , Ss          , Gs^Fp       , Gs^Fp       , Gg          , Gs^Fp       , Gg          , Gs^Fp       
Gs^Fp       , Gs^Fp       , Gs^Fp       , Gg          , Hh^Fp       , Gs^Fp       , Ss          , Gg          , Gs^Fp       , Gg          , Ss          , Gs^Fp       , Gs^Fp       , Ss          , Ur          , Gg          , Gs^Fp       , Gs^Fp       , Gs^Fp       , Ss          , Gs^Fp       , Re          , Gs^Fp       , Re          , Gs^Fp       , Ur          , Ss          , Ss          , Gs^Fp       , Gg          , Re          , Gg          , Gs^Fp       , Ss          , Gs^Fp       , Ss          , Gg          , Gg          , Gg          , Ss          , Gg          , Gs^Fp       , Gs^Fp       , Gs^Fp       , Gs^Fp       , Gs^Fp       
Gs^Fp       , Gs^Fp       , Gs^Fp       , Gs^Fp       , Gg          , Gs^Fp       , Gg          , Gg          , Gs^Fp       , Gg          , Gg          , Gg          , Ss          , Gg          , Gg          , Ss          , Gs^Fp       , Gs^Fp       , Gg          , Gg          , Ss          , Ss          , Re          , Re          , Ss          , Gs^Fp       , Ss          , Gs^Fp       , Gg          , Gg          , Gs^Fp       , Gs^Fp       , Gs^Fp       , Gs^Fp       , Ss          , Gs^Fp       , Gg          , Ss          , Gs^Fp       , Gg          , Gs^Fp       , Gs^Fp       , Hh^Fp       , Gg          , Gs^Fp       , Gs^Fp       
Gs^Fp       , Gg          , Gs^Fp       , Gs^Fp       , Ss          , Ur          , Re          , Gs^Fp       , Gs^Fdw      , Gs^Fp       , Gg^Uf       , Hh^Fp       , Gs^Fp       , Gg          , Hh^Fp       , Gg          , Re          , Re          , Ss          , Gs^Fp       , Gs^Fp       , Ss          , Re          , Gs^Fp       , Gs^Fp       , Gg          , Gg          , Re          , Gs^Fp       , Gg          , Gs^Fp       , Ss          , Gs^Fp       , Gs^Fp       , Gs^Fp       , Gg          , Gs^Fdw      , Gs^Fp       , Ur          , Gs^Fp       , Gg          , Gs^Fp       , Gs^Fp       , Gs^Fp       , Gs^Fp       , Gs^Fp       
Gs^Fp       , Gs^Fp       , Ss          , Gg          , Gs^Fp       , Gs^Fp       , Gs^Fdw      , Gs^Fdw      , Gs^Fdw      , Gs^Fdw      , Gg          , Ss          , Gs^Fp       , Gs^Fp       , Ss          , Gs^Fp       , Ur          , Gs^Fp       , Gg          , Hh^Fp       , Gs^Fp       , Re          , Gs^Fp       , Gs^Fp       , Ss          , Hh^Fp       , Gs^Fp       , Gg          , Re          , Gs^Fp       , Gg          , Gg          , Gg          , Ss          , Gs^Fdw      , Ss          , Gs^Fdw      , Gs^Fp       , Gs^Fp       , Gg          , Gg          , Gs^Fp       , Ss          , Gg          , Gs^Fp       , Gs^Fp       
Gs^Fp       , Gs^Fp       , Gg          , Gs^Fdw      , Ss          , Hh^Fdw      , Gs^Fdw      , Hh^Fdw      , Hh^Fdw      , Gs^Fp       , Gs^Fp       , Gg          , Gg          , Gg          , Gg          , Gg          , Gs^Fp       , Gs^Fp       , Gg          , Ss          , Gg          , Re          , Re          , Gg          , Gg          , Gs^Fp       , Ss          , Ur          , Ss          , Ss          , Gg^Vc       , Gs^Fp       , Gg          , Ur          , Ss          , Gs^Fdw      , Gs^Fdw      , Hh^Fdw      , Gs^Fp       , Gs^Fp       , Re          , Gs^Fp       , Gg          , Ss          , Ss          , Gs^Fp       
Gs^Fp       , Gs^Fp       , Gs^Fp       , Gg          , Gg          , Gs^Fp       , Ur          , Gs^Fp       , Gs^Fp       , Gs^Fp       , Ur          , Gs^Fp       , Gs^Fp       , Gg          , Gg          , Gg^Ve       , Gs^Fp       , Ss          , Gs^Fp       , Ss          , Chr         , Gs^Fp       , Re          , Gg          , Uu^Uf       , Ur          , Hh^Fp       , Ss          , Ss          , Ss          , Gg          , Ss          , Re          , Re          , Hh^Fp       , Gs^Fp       , Gs^Fp       , Ss          , Gg          , Re          , Gs^Fp       , Hh^Fp       , Gg          , Gg          , Gs^Fp       , Gg          
Gs^Fp       , Gs^Fp       , Ss          , Gg          , Gg          , Gg          , Gg          , Ss          , Ww          , Gg          , Gs^Fp       , Hh^Fp       , Gs^Fp       , Re          , Gs^Fdw      , Hh^Fp       , Gg          , Gg          , Gg          , Chr         , 5 Khr       , Chr         , Re          , Gs^Fp       , Gg          , Ss^Vhs      , Ss          , Gs^Fp       , Gs^Fp       , Gs^Fp       , Hh^Fp       , Gg          , Gs^Fp       , Gs^Fp       , Gs^Fp       , Gs^Fp       , Ss          , Gg          , Ss          , Gg          , Gs^Fp       , Gs^Fp       , Re          , Re          , Gs^Fp       , Gs^Fp       
Gs^Fp       , Hh^Fp       , Gg          , Ss          , Re^Vct      , Gs^Fp       , Ww          , Ww          , Gs^Fp       , Ww          , Ww          , Re          , Ww          , Gg          , Wwf         , Ss          , Gg          , Gg          , Gs^Fp       , Chr         , Chr         , Chr         , Re          , Re          , Re          , Re          , Gs^Fp       , Ss          , Gg          , Gs^Fp       , Hh^Fp       , Gs^Fp       , Gs^Fp       , Hh^Fp       , Gs^Fp       , Hh^Fp       , Gs^Fp       , Gs^Fp       , Gs^Fp       , Gg          , Gs^Fp       , Ss          , Gg          , Re          , Gs^Fp       , Ss          
Gs^Fp       , Gg          , Gg          , Gg          , Re          , Re          , Ww          , Gs^Fp       , Chr         , Gs^Fp       , Gg^Vc       , Ww          , Gs^Fp       , Ww          , Ww          , Gs^Fp       , Gs^Vht      , Ss          , Gs^Fp       , Gs^Fp       , Ss          , Gs^Fp       , Re          , Gs^Fp       , Ss          , Gs^Fp       , Gs^Fp       , Ss          , Gg          , Gs^Fp       , Gs^Fp       , Gs^Fp       , Ss          , Ur          , Gg          , Gs^Fp       , Gg          , Gs^Fp       , Gs^Fp       , Gg          , Gs^Fp       , Gg          , Ss          , Ss          , Gs^Fp       , Ss          
Gs^Fp       , Gg          , Ss          , Hh^Fp       , Ww          , Ww          , Gs^Fp       , Chr         , 6 Khr       , Chr         , Gs^Fp       , Gg          , Hh^Fp       , Gs^Fp       , Ss          , Ww          , Ww          , Ww          , Ww          , Ww          , Ww          , Gs^Fp       , Wwf^Bw|     , Gs^Fp       , Hh^Fp       , Gs^Fp       , Gg          , Gg          , Ww          , Ss          , Ww          , Ww          , Ww          , Ss          , Gs^Fp       , Gg^Ve       , Gs^Fp       , Gg          , Ss          , Gs^Fp       , Gs^Fp       , Hh^Fp       , Ww          , Ss          , Ss          , Gs^Fp       
Cud         , Re          , Ww          , Ww          , Gs^Fp       , Hh^Fp       , Gg          , Chr         , Chr         , Chr         , Gs^Fp       , Gg          , Gs^Fp       , Gs^Fp       , Ss          , Hh^Fp       , Gs^Fp       , Ss          , Hh^Fp       , Gg          , Re          , Wwf         , Re          , Wwf         , Wwf         , Ss          , Ww          , Ww          , Gs^Fp       , Ww          , Gg^Vc       , Hh^Fp       , Gg          , Ww          , Ww          , Ww          , Ww          , Ww          , Wwf         , Ww          , Ww          , Ww          , Gg          , Ww          , Ww          , Ww          
Uu          , Cud         , Wwf         , Uu          , Xu          , Gs^Fp       , Gg          , Gg          , Re          , Gg          , Gg          , Gg          , Ss          , Ww          , Gs^Fp       , Re          , Ss          , Re          , Gs^Fdw      , Re          , Hh^Fdw      , Re          , Gs^Fp       , Gg          , Gs^Vht      , Ww          , Ww          , Gg          , Gs^Fp       , Gs^Fp       , Gs^Fp       , Ss          , Chr         , Gg          , Re          , Wwf         , Re          , Ss          , Re          , Ss          , Gs^Fp       , Gs^Fp       , Gg          , Ss          , Gs^Fp       , Gs^Fp       
Uu          , Uu          , Uh          , Uh          , Uu          , Xu          , Gg          , Ur          , Gs^Fp       , Gs^Fp       , Hh^Fp       , Gs^Fp       , Gs^Fp       , Gg          , Ur          , Re          , Gg          , Gg          , Ss          , Re          , Ss          , Hh^Fdw      , Re          , Gs^Fdw      , Gs^Fp       , Gs^Fp       , Ww          , Ur          , Gs^Fp       , Gg^Uf       , Ss          , Chr         , 7 Khr       , Chr         , Ss          , Re          , Gs^Fp       , Gs^Fp       , Gs^Fp       , Hh^Fp       , Gs^Fp       , Ss          , Ss          , Gs^Fp       , Gg          , Gs^Fp       
Uu          , Uu          , Cud         , Uu^Vu       , Cud         , Xu          , Ss          , Gg          , Hh^Fp       , Ss          , Gs^Vht      , Re          , Gs^Fp       , Ss          , Gg          , Ur          , Gs^Fp       , Gs^Fp       , Re          , Re          , Gs^Fp       , Hh^Fp       , Gg          , Gg          , Gs^Fp       , Gg          , Ww          , Ww          , Gg          , Gg          , Gs^Fp       , Chr         , Chr         , Chr         , Gs^Fdw      , Ss          , Gg^Vo       , Gs^Fp       , Ur          , Hh^Fp       , Gs^Fp       , Ss          , Ss          , Ss          , Gs^Fp       , Gs^Fp       
Uh          , Cud         , 8 Kud       , Cud         , Uu          , Uu^Ufi      , Gs^Fp       , Gg          , Gs^Fp       , Gg          , Gs^Fp       , Gs^Fp       , Ww          , Gg          , Re          , Hh^Fp       , Wwf^Bw/     , Re          , Wwf         , Ww          , Ww          , Gs^Vht      , Gg          , Gg          , Re          , Ww          , Re          , Gs^Fp       , Gs^Fp       , Gg          , Gs^Fp       , Gs^Fp       , Gg          , Hh^Fdw      , Gs^Fdw      , Gs^Fdw      , Gs^Fdw      , Ss          , Ww          , Gs^Fp       , Gs^Fp       , Gg          , Ss          , Gs^Fp       , Gs^Fp       , Gs^Fp       
Xu          , Qlf         , Uh          , Uh          , Xu          , Xu          , Ss          , Gg          , Gs^Fp       , Ur          , Gg          , Ss          , Re          , Re          , Ss          , Re          , Re          , Wwf         , Gg          , Gg          , Gg          , Ww          , Ww          , Ww          , Ww          , Ww          , Gg          , Gs^Fp       , Gs^Fp       , Ss          , Gs^Fp       , Gs^Fdw      , Gs^Fp       , Gs^Fdw      , Gs^Fdw      , Hh^Fdw      , Gs^Fp       , Gg          , Gg          , Gg          , Ss          , Gg          , Gg          , Gg          , Ss          , Gs^Fp       
Gs^Fp       , Xu          , Xu          , Xu          , Gs^Fp       , Xu          , Gg          , Ss          , Hh^Fp       , Gg          , Hh^Fp       , Gg          , Re          , Ss          , Re          , Re          , Ss          , Chr         , 4 Khr       , Chr         , Ss          , Gs^Fp       , Gg          , Gg          , Gg          , Gs^Fp       , Gg          , Gs^Fp       , Gg          , Hh^Fp       , Gs^Fdw      , Hh^Fdw      , Gs^Fp       , Hh^Fdw      , Ss          , Ur          , Gs^Fp       , Gs^Fp       , Gs^Fp       , Ss          , Ss          , Ss          , Ss          , Ss          , Ss          , Gs^Fp       
Gs^Fp       , Gg          , Gs^Fp       , Gs^Fp       , Gs^Fp       , Gg          , Ss          , Gg          , Gs^Fp       , Ss          , Gs^Fp       , Gs^Fp       , Re          , Hh^Fp       , Re          , Gs^Fp       , Ss          , Chr         , Chr         , Chr         , Gg          , Gs^Fp       , Gs^Fp       , Gs^Fp       , Gg          , Hh^Fp       , Ss          , Gg          , Re          , Gg          , Gs^Fp       , Gs^Fp       , Gg          , Gs^Fp       , Ss^Vhs      , Gg          , Ur          , Hh^Fp       , Gg          , Ss          , Gg          , Gg          , Ss          , Gs^Fp       , Gs^Fp       , Gs^Fp       
Gs^Fp       , Gg          , Gg          , Hh^Fp       , Ss          , Hh^Fp       , Re          , Gg          , Ss          , Gg          , Gs^Fp       , Re          , Gs^Fp       , Re          , Gs^Fp       , Gg          , Gs^Fp       , Re          , Gs^Fp       , Gs^Fp       , Gg          , Gs^Fp       , Gg          , Gs^Fp       , Hh^Fp       , Gs^Fp       , Gg          , Gs^Uf       , Gs^Fp       , Gg          , Re          , Gs^Fp       , Ss          , Gs^Fp       , Gs^Uf       , Gg          , Gg          , Ss          , Gs^Fp       , Gs^Fp       , Ss          , Gs^Fp       , Ss          , Ss          , Gs^Fp       , Gs^Fp       
Gs^Fp       , Gg          , Gg          , Gs^Fp       , Gg          , Gs^Fp       , Hh^Fp       , Ss          , Gs^Fp       , Ur          , Gs^Fp       , Re          , Ss          , Hh^Fp       , Ss          , Gg          , Ss          , Re          , Gs^Fp       , Hh^Fp       , Gs^Fp       , Gg          , Gs^Fp       , Gs^Fp       , Gs^Fp       , Gs^Fp       , Gg          , Gg          , Gg          , Ww          , Gs^Fp       , Gs^Fp       , Gs^Fp       , Hh^Fp       , Ss          , Gg          , Gs^Fp       , Gs^Fp       , Gs^Fp       , Gs^Fp       , Gs^Fp       , Gs^Fp       , Gs^Fp       , Ss          , Gs^Fp       , Gs^Fp       
Gs^Fp       , Gg          , Gs^Fp       , Gg          , Ur          , Ss          , Ss          , Wwf         , Gg          , Gs^Fp       , Gs^Fp       , Re          , Gg          , Gg          , Gg          , Hh^Fp       , Re          , Re          , Ss          , Gs^Fp       , Ss          , Gs^Fp       , Gg          , Gs^Fp       , Re          , Gs^Fp       , Ss          , Ss          , Hh^Fp       , Gg          , Gg          , Ss          , Gs^Fp       , Gs^Fp       , Gg          , Gs^Fp       , Gg          , Gs^Fp       , Gg          , Ss          , Re          , Gg          , Ss          , Gs^Fp       , Ss          , Gs^Fp       
Gs^Fp       , Gs^Fp       , Gs^Fp       , Gg          , Gs^Fp       , Gg^Vc       , Gs^Fdw      , Gs^Fp       , Gs^Fp       , Ss          , Re          , Re          , Gg          , Gs^Fp       , Gs^Fp       , Gs^Fp       , Re          , Gg          , Gs^Fp       , Ss^Vhs      , Ww          , Gs^Fp       , Hh^Fp       , Gs^Fp       , Gg          , Hh^Fp       , Gs^Fp       , Gs^Fp       , Gs^Fp       , Re          , Gg          , Gg          , Gs^Fp       , Gs^Fp       , Ww          , Gg          , Gs^Fp       , Gs^Fp       , Gs^Fp       , Gs^Fp       , Hh^Fp       , Gg          , Gs^Fp       , Ss          , Gs^Fp       , Gs^Fp       
Gs^Fp       , Gs^Fp       , Ww          , Gs^Fp       , Gs^Fp       , Gg          , Gs^Fdw      , Gs^Fdw      , Hh^Fdw      , Hh^Fp       , Re          , Hh^Fp       , Gg          , Gg          , Re          , Re          , Gg          , Gs^Fp       , Re          , Ss          , Wwf         , Gg          , Ur          , Gs^Fp       , Re          , Gg          , Gs^Fp       , Gg          , Gs^Fp       , Gs^Fp       , Gg          , Gs^Fp       , Gg          , Gs^Fp       , Ss          , Ur          , Ur          , Hh^Fp       , Gg          , Re          , Gs^Fp       , Gg^Vo       , Gg          , Gs^Fp       , Gs^Fp       , Gs^Fp       
Ss          , Gs^Fp       , Gs^Fp       , Gg          , Ss          , Gs^Fdw      , Gs^Fdw      , Uu^Uf       , Re          , Re          , Ss          , Gs^Fp       , Ur          , Gg          , Re          , Gs^Fp       , Gs^Fp       , Gs^Fp       , Gg          , Gg          , Gs^Fp       , Gs^Fp       , Gg          , Gs^Fp       , Gs^Fp       , Gs^Fp       , Gg          , Gs^Fp       , Gg          , Gg          , Hh^Fp       , Gs^Fp       , Gs^Fp       , Gs^Fp       , Gs^Fdw      , Gs^Fp       , Gs^Fp       , Ss          , Gg          , Gs^Fp       , Ss          , Ss          , Ss          , Ss          , Gs^Fp       , Gs^Fp       
Gs^Fp       , Gg          , Gg          , Hh^Fp       , Ur          , Gg          , Gs^Fp       , Gs^Fp       , Re          , Ss          , Gg          , Gg          , Re          , Re          , Gg          , Gg          , Gs^Fp       , Gs^Fp       , Gs^Fp       , Gg          , Ss          , Re          , Gs^Fp       , Gs^Fp       , Ss          , Gs^Fp       , Gs^Fp       , Ss          , Gg          , Gs^Uf       , Gg          , Gs^Fp       , Gs^Fdw      , Hh^Fdw      , Gs^Fdw      , Gs^Fp       , Gs^Vht      , Gs^Fp       , Gs^Fp       , Gs^Fp       , Ss          , Gg          , Gg          , Re          , Re          , Gs^Fp       
Gs^Fp       , Gs^Fp       , Ss          , Hh^Fp       , Ss          , Gg          , Ss          , Re          , Re^Vct      , Gs^Fp       , Gg          , Ss          , Re          , Gs^Fp       , Ss          , Gg          , Re          , Ur          , Gs^Fp       , Ss          , Gg          , Gs^Fp       , Re          , Gs^Fp       , Ss          , Gs^Fp       , Ss          , Gg          , Ss          , Gs^Fp       , Gs^Fp       , Ss          , Gs^Fdw      , Gs^Fdw      , Gs^Fdw      , Hh^Fdw      , Gs^Fp       , Gs^Fp       , Ss          , Gg          , Gs^Fp       , Ss          , Gs^Fp       , Gg          , Gs^Fp       , Gs^Fp       
Gs^Fp       , Gs^Fp       , Gg          , Gg          , Gg          , Gs^Fp       , Ww          , Re          , Re          , Ss          , Ss          , Ss          , Re          , Gs^Fp       , Gg          , Gg          , Gs^Fp       , Gg          , Gs^Fp       , Ss          , Gs^Fp       , Ss          , Gg          , Ss          , Gg          , Gg          , Gs^Fp       , Gg          , Gs^Fp       , Gg          , Gg          , Ss          , Ss          , Gs^Fdw      , Hh^Fdw      , Gs^Fp       , Gs^Fp       , Ss          , Ur          , Ss          , Gs^Fp       , Gs^Fp       , Ss          , Gs^Fp       , Gs^Fp       , Gs^Fp       
Gs^Fp       , Ss          , Gg^Vo       , Ss          , Gs^Fp       , Ss          , Gs^Fp       , Ss          , Re          , Gs^Fp       , Gs^Fp       , Re          , Ss^Vhs      , Gs^Fp       , Gs^Fp       , Ss          , Ww^Uf       , Gg          , Gs^Fp       , Gs^Fp       , Gg          , Gs^Fp       , Gg          , Hh^Fp       , Gs^Fp       , Gg          , Gg          , Ss          , Gs^Fp       , Hh^Fdw      , Gg^Vc       , Gs^Fp       , Gs^Fdw      , Gs^Fp       , Gs^Fp       , Re          , Gg^Uf       , Ss          , Gs^Fp       , Gs^Fp       , Gs^Fp       , Gs^Fp       , Gs^Fp       , Gs^Fp       , Gs^Fp       , Gs^Fp       
Gs^Fp       , Gg          , Gg          , Gs^Fp       , Gs^Fp       , Ss          , Gs^Fp       , Re          , Hh^Fp       , Ss          , Ss          , Re          , Gs^Fp       , Ss          , Gg          , Hh^Fp       , Gg          , Gg          , Ss          , Gs^Fp       , Re          , Gg          , Gs^Fp       , Gg          , Ss          , Gs^Fp       , Gs^Fp       , Gs^Fp       , Gs^Fp       , Ss          , Gg          , Gg          , Gs^Fp       , Hh^Fp       , Wwf         , Gs^Fp       , Gs^Fp       , Gg          , Gg          , Gg          , Gs^Fp       , Ss          , Gs^Fp       , Ss          , Ss          , Gs^Fp       
Gs^Fp       , Ss          , Gs^Fp       , Gs^Fp       , Ce          , Gg          , Re          , Re          , Ce          , Gs^Fp       , Gs^Fp       , Gs^Fp       , Ce          , Gg          , Gs^Fp       , Gs^Fp       , Gs^Fp       , Gs^Fp       , Gg          , Gg          , Gg          , Gs^Fp       , Ww          , Gs^Fp       , Gs^Fp       , Gs^Fp       , Ss          , Gg          , Gs^Fp       , Gg          , Gs^Fp       , Gs^Fp       , Gg          , Gg          , Gg          , Gs^Fp       , Gg          , Re          , Gg          , Ss          , Gs^Fp       , Gg          , Hh^Fp       , Gs^Fp       , Gs^Fp       , Gs^Fp       
Gs^Fp       , Gs^Fp       , Gs^Fp       , Ce          , 2 Ke        , Ce          , Re          , Ce          , 1 Ke        , Ce          , Gs^Fp       , Ce          , 3 Ke        , Ce          , Ss          , Gg          , Ss          , Gs^Fp       , Gs^Fp       , Re          , Ss          , Gg          , Gg          , Gs^Fp       , Ss          , Gs^Fp       , Gg          , Ss          , Hh^Fp       , Gs^Fp       , Gg          , Gs^Fp       , Hh^Fp       , Re          , Ss          , Gs^Fp       , Hh^Fp       , Gg          , Hh^Fp       , Ss          , Gs^Fp       , Gs^Fp       , Gg          , Gg          , Gs^Fp       , Gs^Fp       
Gs^Fp       , Ss          , Gs^Fp       , Ce          , Ce          , Ce          , Re          , Ce          , Ce          , Ce          , Gs^Fp       , Ce          , Ce          , Ce          , Gg          , Gs^Fp       , Gs^Fp       , Gs^Fp       , Gg          , Gg          , Ss          , Gs^Fp       , Gs^Fp       , Re          , Gs^Fp       , Gs^Fp       , Gs^Fp       , Gg          , Gs^Fp       , Ss          , Gs^Fp       , Ss          , Gs^Fp       , Gg          , Ss          , Gs^Fp       , Gs^Fp       , Ss          , Gg          , Gs^Fp       , Gs^Fp       , Gg          , Gg          , Re          , Gg          , Gs^Fp       
Gs^Fp       , Gs^Fp       , Gs^Fp       , Gs^Fp       , Gs^Fp       , Gs^Fp       , Gs^Fp       , Re          , Gs^Fp       , Gs^Fp       , Gs^Fp       , Gs^Fp       , Gs^Fp       , Gs^Fp       , Gs^Fp       , Gs^Fp       , Gs^Fp       , Gs^Fp       , Gs^Fp       , Gs^Fp       , Gs^Fp       , Gs^Fp       , Gs^Fp       , Gs^Fp       , Gs^Fp       , Gs^Fp       , Gs^Fp       , Gs^Fp       , Gs^Fp       , Gs^Fp       , Gs^Fp       , Gs^Fp       , Gs^Fp       , Ss          , Gs^Fp       , Ss          , Gs^Fp       , Gs^Fp       , Gs^Fp       , Gs^Fp       , Gs^Fp       , Gs^Fp       , Gs^Fp       , Gg          , Gs^Fp       , Gs^Fp       
