border_size=1
usage=map

Gs^Fdw      , Gs^Fmw      , Gs^Fms      , Gs^Fp       , Gs^Fmw      , Gs^Fdw      , Hh^Fmw      , Re          , Gs^Fdw      , Gs^Fmw      , Hh^Fdw      , Gs^Fdw      , Gs^Fmw      , Ww          , Ww          , Hh^Fms      , Gs^Fms      , Gs^Fms      , Gs^Fp       , Hh^Fms      , Gs^Fp       , Hh^Fms      , Gs^Fp       , Gs^Fms      , Hh^Fms      , Gs^Fp       , Gs^Fp       , Hh^Fms      , Hh^Fms      , Hh^Fms      , Hh^Fms      , Gs^Fp       
Gs^Fms      , Gs^Fmw      , Gs^Fmw      , Hh          , Hh^Fmw      , Hh          , Re          , Re          , Gs^Fdw      , Hh^Fdw      , Gs^Fmw      , Hh^Fdw      , Gs^Fdw      , Ww          , Ww          , Hh^Fms      , Gs^Uf       , Re          , Re^Vct      , Gs^Fms      , Gs^Fms      , Gs^Fms      , Hh          , Gs^Fms      , Gs^Fms      , Gs^Fms      , Re^Uf       , Gs^Fms      , Gs^Fms      , Hh^Fms      , Hh^Fms      , Hh^Fms      
Hh^Fmw      , Gs^Fmw      , Hh          , Hh          , Re          , Re          , Gs^Fmw      , Gs^Fmw      , Gs^Fmw      , Gs^Fdw      , Gs^Fmw      , Gs^Fdw      , Wwf         , Ww^Vm       , Ww          , Hh^Fms      , Re          , Re          , Gs^Fms      , Gs^Fms      , Re          , Gs^Fms      , Gs^Fms      , Gs^Fp       , Re          , Gg^Vo       , Cud         , Cud         , Cud         , Gs^Fms      , Gs^Fms      , Hh^Fms      
Gs^Fp       , Hh^Fdw      , Hh          , Hh^Fp       , Re          , Gs^Fmw      , Ss          , Ss          , Ss          , Gs^Fmw      , Re          , Gs^Fdw      , Gs^Fdw      , Ww          , Wwf         , Re          , Re          , Re          , Re          , Re          , Gs^Fdw      , Re          , Chr         , Re          , Hh          , Re^Uf       , Cud         , Cud         , 4 Kud^Ii    , Cud         , Re^Uf       , Hh^Fms      
Re          , Re          , Re          , Gs^Fmw      , Re          , Gs^Fmw      , Ss          , Gs^Uf       , Gs^Fmw      , Gs^Fmw      , Re^Vct      , Re          , Gs^Fp       , Ww          , Wwf         , Gs^Fdw      , Gs^Fmw      , Gs^Fdw      , Gs^Fdw      , Gs^Fdw      , Gs^Fdw      , Re          , Re          , Re          , Re          , Cud         , Cud         , Cud         , Cud         , Cud         , Re^Vct      , Hh^Fdw      
Gs^Fp       , Gs^Fms      , Re          , Re          , Gs^Fmw      , Gs^Fmw      , Hh^Fp       , Ss          , Gs^Fmw      , Gs^Fmw      , Re          , Re          , Gs^Fp       , Wwf         , Ww          , Wwf         , Gs^Fmw      , Hh          , Gs^Uf       , Gs^Fmw      , Gs^Fmw      , Gs^Fdw      , Gs^Fmw      , Gs^Fdw      , Gs^Fdw      , Re^Uf       , Re^Uf       , Re^Uf       , Re          , Re^Uf       , Gs^Fms      , Gs^Fp       
Gs^Uf       , Gs^Fms      , Gs^Fms      , Re          , Re          , Ss^Vhs      , Ss          , Ss          , Gs^Fmw      , Re          , Gs^Fmw      , Hh          , Wwf         , Ww          , Wwf         , Ds          , Gs^Fmw      , Mm          , Hh^Fmw      , Gs          , Gs          , Hh          , Gs          , Gs^Fmw      , Hh^Fmw      , Gs^Fdw      , Gs^Fmw      , Re          , Re          , Gs^Fms      , Gs^Fms      , Gs^Fp       
Gs^Fp       , Gs^Fp       , Gs^Fms      , Re          , Re          , Gs^Fmw      , Gs^Fmw      , Re          , Ss          , Ss          , Gs^Fmw      , Gs^Fp       , Wwf         , Ww          , Wwf^Uf      , Ds          , Hh^Fdw      , Hh          , Re          , Gs^Fmw      , Gs^Fmw      , Gs^Fmw      , Gs^Fmw      , Gs^Fmw      , Ss^Fdw      , Gs          , Gs^Fmw      , Hh^Fmw      , Gs^Fdw      , Re          , Gs^Fms      , Gs^Fp       
Gs^Uf       , Gs^Fp       , Gs^Uf       , Gs^Fms      , Gs^Fms      , Re          , Gs^Fmw      , Gs^Fmw      , Ss          , Gs^Fmw      , Gs^Fp       , Gs^Fp       , Ww^Bw/      , Khr         , Ww^Bw\      , Hh^Vhh      , Re          , Re          , Hh^Fdw      , Re          , Re          , Hh^Fmw      , Ss          , Ss          , Ss^Fdw      , Gs^Fmw      , Re^Uf       , Re^Uf       , Re          , Re          , Gs^Fms      , Gs^Fp       
Gs^Fp       , Gs^Fp       , Gs^Fms      , Gs^Fms      , Re          , Re          , Gs^Fmw      , Ss          , Gs^Fmw      , Gs^Fmw      , Gs^Fp       , Re          , Ww          , Chr         , Ww          , Re          , Gs^Fmw      , Hh^Fmw      , Mm          , Hh          , Re          , Ss^Vhs      , Ss^Fdw      , Ss^Fdw      , Gs^Fmw      , Gs^Fmw      , Re^Uf       , Gs^Fms      , Gs^Fms      , Gs^Fms      , Gs          , Gs^Fp       
Gs^Fms      , Gs^Fms      , Gs^Fms      , Re          , Gs^Fms      , Re          , Gs^Fmw      , Gs^Fmw      , Gs^Fms      , Gs^Fms      , Gs^Fp       , Re          , Wwf         , Wwf         , Ww          , Re          , Gs          , Gs          , Gs          , Gs          , Re          , Ss          , Ss^Fdw      , Gs^Fmw      , Re          , Re          , Gs^Fms      , Hh^Fms      , Gs^Fms      , Gs^Fp       , Gs          , Gs^Fp       
Gs^Fms      , Ce          , Re          , Re          , Re          , Re          , Hh^Fp       , Hh^Fms      , Ss          , Gs^Fp       , Gs^Fp       , Re          , Hh^Fdw      , Wwf         , Ww          , Re          , Gs^Uf       , Hh^Fp       , Hh          , Gs          , Ss          , Re          , Gs^Fmw      , Hh^Fmw      , Re          , Gs^Fms      , Hh^Fms      , Ss          , Gs^Fms      , Gs          , Gs^Uf       , Gs^Uf       
Gs^Fms      , Ce          , Re          , Re^Vct      , Gs^Fms      , Hh^Fdw      , Ss^Fdw      , Gs^Fmw      , Ss          , Gs^Fmw      , Gs^Fdw      , Re          , Re          , Wwf         , Ww          , Re          , Gs^Fms      , Gs^Fms      , Gs          , Gg^Vo       , Gs          , Re          , Re          , Re          , Ss^Uf       , Ss^Uf       , Ss          , Ss          , Gs^Uf       , Gs^Uf       , Hh^Uf       , Hh^Fms      
Gs^Fms      , Ce          , Re          , Gs^Fms      , Gs^Fmw      , Hh^Fdw      , Ss^Fdw      , Ss          , Ss          , Ss^Vhs      , Ss^Fdw      , Gs^Fp       , Re          , Ww          , Re          , Re          , Gs^Fmw      , Gs^Fms      , Gs^Fms      , Gs          , Gs^Fms      , Gs          , Hh^Fms      , Hh^Fms      , Ss          , Ss^Fms      , Ss          , Hh^Uf       , Gs          , Gs          , Hh^Fms      , Hh^Fms      
Gs^Fms      , Ce          , Re          , Gs^Fms      , Gs^Fp       , Gs^Fmw      , Ss^Fdw      , Gs          , Ss^Fdw      , Ss          , Ss^Fdw      , Gs^Fp       , Re          , Ww^Bw/      , Wwf         , Gs^Fmw      , Gs^Fdw      , Gs^Fp       , Gs^Fp       , Gs^Fms      , Gs^Fms      , Gs          , Gs          , Gs^Fms      , Gs^Fms      , Ss          , Gs^Fp       , Gs^Fp       , Hh^Fms      , Gs^Vht      , Gs          , Gs^Fp       
Gs^Fms      , Ce          , Re          , Gs^Fms      , Re          , Gs^Fp       , Re          , Ss^Fdw      , Re          , Ss^Fdw      , Re          , Re          , Gs^Fp       , Ww          , Ww          , Hh^Fmw      , Ds          , Gs^Fmw      , Gs^Fmw      , Gs^Fmw      , Gs^Fp       , Gs^Fms      , Gs^Fms      , Gs          , Gs^Fms      , Gs^Fp       , Gs^Fms      , Gs          , Gs          , Gs          , Gs^Fp       , Gs^Fp       
Gs^Fp       , 2 Ke^Ii     , Re          , Re          , Re          , Re          , Re          , Re          , Gs^Fms      , Re          , Gs^Fmw      , Gs^Vht      , Gs^Fp       , Ds          , Dd^Vda      , Ww          , Ds          , Ur^Fmw      , Chr         , Gs^Fmw      , Gs^Fdw      , Gg^Ve       , Gs^Fmw      , Gs          , Gs^Fms      , Gs^Uf       , Gs          , Gs^Fms      , Gs^Fms      , Ce          , Gs^Fp       , Gs^Fp       
Re          , Re          , Ce          , Ce          , Ce          , Ce          , Re          , Re          , Hh          , Gs^Fp       , Hh          , Gs^Fms      , Hh^Fp       , Gs^Fp       , Ds          , Ww          , Ds          , Ur^Fdw      , Ur          , Ur^Fdw      , Ur^Fdw      , Gs^Fmw      , Gs^Fdw      , Gs          , Gs          , Gs          , Gs          , Gs^Fms      , Ce          , 5 Ke        , Gs^Fp       , Gs^Fp       
Re          , Re          , Ce          , 3 Ke^Ii     , Ce          , 1 Ke^Ii     , Ce          , Re          , Gs^Fp       , Gs^Fmw      , Re          , Gs^Fmw      , Uu          , Ur          , Ds          , Wwf         , Wwf^Uf      , Ur          , Ur^Fdw      , Ur          , Ur          , Ur^Fdw      , Gs^Fmw      , Gs          , Gs          , Gs^Fms      , Gs^Fms      , Gs          , Gs^Fms      , Ce          , Gs          , Gs^Fp       
Re          , Gs^Fdw      , Ce          , Ce          , Gs^Fmw      , Ce          , Ur          , Ur          , Ur          , Ur          , Uu          , Re          , Xu          , Uh          , Ur          , Wwf         , Ur          , Ur          , Uh^Fdw      , Ur^Fdw      , Ur^Uf       , Ur^Fdw      , Ur          , Gs          , Gs          , Gs^Fms      , Gs^Fms      , Gs          , Gs^Fms      , Gs          , Gs^Fms      , Gs^Uf       
Gs^Fdw      , Gs^Fdw      , Gs^Fms      , Gs^Fdw      , Gs^Fms      , Gs^Fmw      , Ur^Uf       , Ur          , Uu^Vu       , Xu          , Xu          , Uu          , Xu          , Uu          , Uu^Uf       , Ww          , Uh          , Uh^Uf       , Uu^Fdw      , Xu          , Uh^Fdw      , Ur^Fdw      , Ur^Fdw      , Gs^Fmw      , Gs^Fmw      , Gs          , Gs          , Gs          , Gs          , Gs          , Gs^Uf       , Gs^Fms      
Gs^Fmw      , Gs^Fmw      , Gs^Fmw      , Gs^Fmw      , Gs^Fmw      , Gs^Fmw      , Gs^Fmw      , Ur^Uf       , Ur^Uf       , Uh          , Xu          , Ur^Fdw      , Qxu         , Qxu         , Uu^Fdw      , Ww          , Ur^Fdw      , Xu          , Xu          , Xu          , Uh^Uf       , Uh^Uf       , Uh^Uf       , Ur^Fdw      , Gs^Fmw      , Gs^Fms      , Gs^Fmw      , Gs^Uf       , Gs^Fms      , Gs^Fms      , Gs^Uf       , Gs^Uf       
