border_size=1
usage=map

Gs^Fdw      , Gs^Fdw      , Gs^Fdw      , Gs^Fdw      , Gs^Fdw      , Gs^Fdw      , Gs^Fdw      , Gs^Fp       , Gs^Fdw      , Gs^Fdw      , Gs^Fdw      , Gs^Fp       , Gs^Fp       , Gs^Fp       , Gs^Fp       , Gs^Fp       , Gs^Fp       , Gs^Fp       , Gs^Fp       , Gs^Fp       , Gs^Fp       , Gs^Fp       , Gs^Fp       , Gs^Fp       , Gs^Fp       , Gs^Fp       , Gs^Fp       , Gs^Fp       , Gs^Fp       , Gs^Fp       , Gs^Fp       , Gs^Fp       , Gs^Fp       , Gs^Fp       , Re          , Gs^Fp       , Re          , Gs^Fmw      , Gs^Fmw      , Gs^Fmw      , Gs^Fmw      , Gs^Fmw      , Wo          , Wo          , Wo          , Wo          
Gs^Fdw      , Gs^Fdw      , Chr         , Chr         , Chr         , Gs^Fdw      , Gs          , Gs^Fmw      , Gs^Fmw      , Gs          , Gs          , Hh^Fp       , Gs          , Gs^Fp       , Gs^Fp       , Chs         , Gs^Fp       , Gs^Fp       , Hh          , Gs^Fp       , Gs^Fp       , Gs^Fp       , Gs^Fp       , Gs^Fp       , Gs^Fp       , Gs^Fp       , Gs^Fp       , Gs^Fp       , Gs          , Gs^Fp       , Gs^Fp       , Gs^Fp       , Gs^Fp       , Gs^Fp       , Gs          , Re          , Gs          , Gs^Fmw      , Gs          , Gs^Fmw      , Wo          , Wo          , Chr         , Wo          , Gs^Fdw      , Gs^Fdw      
Gs^Fdw      , Gs^Fdw      , Chr         , 7 Khr^Ii    , Chr         , Gs^Fdw      , Gs^Fmw      , Hh^Vhh      , Gs          , Gs^Fmw      , Hh^Fp       , Gs^Fp       , Hh^Uf       , Hh^Fdw      , Gs          , Gs^Fp       , Gs^Fp       , Hh^Fdw      , Mm          , Hh          , Gs          , Gs          , Gs          , Gs^Fp       , Gs^Fp       , Gs^Fp       , Hh^Fp       , Gs          , Gs          , Gs          , Gs          , Gs          , Ds          , Gs          , Gs^Fp       , Re          , Gs^Fmw      , Gs^Uf       , Wo          , Wo          , Wo          , Chr         , 4 Khr^Ii    , Chr         , Gs^Fdw      , Gs^Fdw      
Gs^Fdw      , Gs^Fdw      , Gs^Fdw      , Chr         , Gs^Fdw      , Gs          , Hh^Fdw      , Ss          , Gs          , Gs^Fmw      , Gs          , Gs          , Gs^Fp       , Gs^Fp       , Gs^Fdw      , Gs          , Gs^Fp       , Hh^Fdw      , Mm          , Gs          , Gg^Vo       , Gg          , Gs^Fp       , Gs^Fp       , Gs^Fp       , Ss          , Gs          , Gs^Fp       , Gs          , Gs          , Gs^Fp       , Ds          , Wo          , Wo          , Wo          , Re          , Wo          , Ww^Vm       , Wo          , Wo          , Gs^Fdw      , Chr         , Chr         , Chr         , Gs^Fdw      , Gs^Fdw      
Gs^Fmw      , Hh^Fmw      , Gs^Fmw      , Gs          , Gs^Fmw      , Gs^Fmw      , Gs^Fmw      , Gs          , Gs^Fdw      , Gs^Fdw      , Ss          , Gs          , Ss          , Hh^Uf       , Ss          , Hh^Fdw      , Ss          , Hh          , Ss          , Hh^Fmw      , Hh^Fp       , Ss^Uf       , Re          , Ss^Uf       , Ss^Uf       , Gs^Fp       , Gs^Fp       , Gs          , Gs          , Gs^Fp       , Wo          , Wo          , Wo          , Wo          , Wo          , Wo^Bw|      , Wwf         , Wo          , Dd^Vdt      , Hh^Fdw      , Gs^Fdw      , Gs^Fdw      , Gs^Fdw      , Gs^Fdw      , Hh^Fdw      , Gs^Fdw      
Gs^Fmw      , Hh^Fmw      , Gs^Fmw      , Gs^Vht      , Ss          , Hh^Fdw      , Uu^Uf       , Hh^Fmw      , Hh          , Gs^Fmw      , Chs^Uf      , Ss^Uf       , Gs^Fp       , Gs^Fdw      , Hh^Fp       , Ss          , Hh^Fmw      , Ss          , Mm          , Ss          , Ss          , Re          , Re          , Re          , Re          , Gs^Fp       , Re          , Gs^Fp       , Wo          , Wo          , Wo          , Wo          , Ds          , Gs^Fp       , Gs^Fp       , Wo^Bw|      , Gs^Fmw      , Ds          , Gs^Fmw      , Gs^Fdw      , Gs^Fdw      , Gs^Fdw      , Ur          , Ur          , Gs^Fdw      , Gs^Fdw      
Ur^Uf       , Gs^Fmw      , Hh^Fmw      , Gs^Uf       , Gs^Uf       , Gs^Uf       , Gs^Uf       , Hh          , Mm          , Ss          , Hh^Fdw      , Ss          , Gs^Fp       , Gs^Fp       , Gs^Fp       , Gs          , Hh^Fmw      , Mm          , Hh^Fp       , Hh^Fmw      , Gs^Fp       , Ss          , Ss          , Ss          , Ds          , Re          , Wo^Bw\      , Wo          , Wo          , Wo          , Gg          , Ww          , Ss          , Gg          , Gs^Fp       , Gg          , Gs^Fmw      , Gs^Fmw      , Gs^Fmw      , Hh^Fdw      , Gs^Fdw      , Hh^Fdw      , Gs^Fdw      , Ur          , Gs^Fdw      , Gs^Fdw      
Ur^Uf       , Ur          , Ur          , Ur^Fp       , Ur^Fp       , Gs^Uf       , Gs^Uf       , Hh^Fdw      , Gs^Fp       , Mm          , Hh^Fp       , Ss          , Re          , Gs^Fp       , Re          , Gs^Fp       , Ss          , Gs^Fp       , Gs^Fp       , Hh^Fp       , Gs^Fp       , Gs^Fp       , Ss          , Gs^Fp       , Wo          , Wo          , Wo          , Wo^Bw\      , Gg          , Ds          , Gg          , Ww          , Ww          , Gg          , Gs^Fp       , Gg          , Gg          , Ss          , Gs^Fmw      , Gs^Fdw      , Gs^Fdw      , Gs^Fdw      , Gs^Fmw      , Ss          , Ur          , Gs^Fdw      
Ur^Fp       , Ur^Fp       , Ur          , Ur^Fp       , Ur^Fp       , Hh^Fp       , Ur^Fp       , Hh^Fp       , Gs          , Ss          , Gs^Fp       , Re          , Hh^Fp       , Gs^Fp       , Re          , Gs^Fp       , Gs^Fp       , Gs          , Gs^Fp       , Gs^Fp       , Gs^Fp       , Wwf         , Wo          , Wo          , Wo          , Wo          , Gs^Fp       , Gg          , Hh^Fp       , Gs^Fp       , Hh          , Gs^Fp       , Ww          , Gs^Fp       , Ss^Vhs      , Gg          , Gs^Fp       , Rd          , Gs^Fmw      , Ur          , Ur          , Ss          , Gg^Ve       , Gs^Fmw      , Ur          , Gs^Fmw      
Uu^Uf       , Ur          , Uh          , Ur          , Ur          , Ur^Fp       , Ur^Fp       , Ur^Fp       , Gs^Fp       , Gs          , Gs^Fp       , Re          , Re          , Re          , Gs^Fp       , Gs^Fp       , Gs^Fp       , Gs^Fp       , Gs^Fp       , Gs^Fp       , Wo          , Wo          , Wo          , Wo          , Gs^Fp       , Ss          , Ss          , Rd          , Hh^Fp       , Gg          , Hh^Fms      , Ww          , Gg          , Hh^Fp       , Gs^Fp       , Gs^Fp       , Gs^Fp       , Gg          , Gs^Fmw      , Gs^Fmw      , Gs^Fmw      , Gs^Fmw      , Ur          , Ur          , Gs^Fmw      , Gs^Fmw      
Xu          , Uu          , Uu          , Ur^Uf       , Ur          , Ur          , Ur          , Ur^Fp       , Gs^Fp       , Gs          , Hh^Fp       , Gs^Fp       , Gs^Fp       , Re          , Re          , Re          , Re          , Ds^Uf       , Wo          , Wo          , Wo          , Wo          , Gs^Fp       , Gg          , Ss          , Gg          , Gs^Fp       , Gg          , Rd          , Gs^Fp       , Hh^Fp       , Ww          , Hh^Fp       , Gs^Fp       , Ss          , Ss          , Gg          , Gg          , Gg          , Ss          , Gs^Fmw      , Gs^Fmw      , Ur          , Hh^Fmw      , Gs^Fmw      , Gs^Fmw      
Xu          , Xu          , Uu^Uf       , Uh          , Ur^Fp       , Ur          , Uh^Uf       , Gs^Fp       , Gs^Fp       , Hh^Fp       , Gs^Fp       , Gs^Fp       , Gs          , Gs^Fp       , Gs          , Dd^Vdt      , Wo          , Wo^Bw\      , Wo^Bw\      , Wo          , Ds          , Gg          , Gg          , Ur          , Ur          , Ss          , Gg          , Gg          , Gs^Fdw      , Gs^Fp       , Hh          , Hh          , Gs^Fp       , Ss          , Gs^Fp       , Gs^Fp       , Rd          , Chs         , Gs^Fp       , Gs^Fp       , Gs^Fmw      , Ur          , Ur^Fmw      , Ur^Fmw      , Gs^Fmw      , Gs^Fmw      
Xu          , Xu          , Uu          , Ur^Fp       , Ur^Uf       , Ur          , Ss          , Gs^Fp       , Gs^Fp       , Gg          , Gs^Fp       , Gs^Fp       , Ds          , Ds          , Wo          , Wo          , Wo          , Wo          , Ss^Fp       , Ss^Fp       , Gg          , Gs^Fp       , Hh^Fp       , Gs^Fp       , Re          , Gg          , Gs^Fp       , Hh^Fdw      , Ur          , Ss          , Gg          , Gs^Fp       , Gg          , Rd          , Gg          , Gg          , Gg          , Gs^Fp       , Gs^Fp       , Gs^Fp       , Ur^Fp       , Ur^Fmw      , Ur          , Gs^Fmw      , Gs^Fmw      , Gs^Fmw      
Xu          , Xu          , Uu          , Ur^Fp       , Ur          , Ur          , Ur          , Ss          , Gs^Fp       , Gs          , Gs          , Gs^Fp       , Wo          , Wo          , Wo          , Wo          , Ss          , Ss^Fp       , Ur          , Ss^Fp       , Ss^Fp       , Gg          , Gg          , Re          , Ce          , Ce          , Ce          , Gs^Vht      , Gs^Fp       , Gs^Fp       , Gg          , Gg          , Gg          , Gs^Fp       , Gs^Fp       , Gs^Fp       , Gs^Fp       , Ur          , Ur^Fp       , Ur^Fp       , Ur          , Ur          , Gs^Fp       , Gs^Fp       , Gs^Fp       , Gs^Fmw      
Xu          , Xu          , Uu          , Ur^Fp       , Ur          , Ur^Fp       , Ur          , Ur          , Gs          , Gs^Fp       , Wo          , Wo          , Wo          , Wo          , Ss          , Ss          , Ss          , Ur          , Hh^Fp       , Ur          , Ur          , Ss^Fp       , Re          , Re          , Ce          , 2 Ke^Ii     , Ce          , Gs^Fp       , Gs^Fp       , Gg          , Gs^Fp       , Ss          , Ur          , Gs^Fp       , Gs^Fp       , Gs^Fp       , Gs^Fp       , Gs^Fp       , Ur          , Gs^Fp       , Gs^Fp       , Hh^Fp       , Gs^Fp       , Ss          , Gs^Fp       , Gs^Fp       
Uu^Uf       , Uu^Uf       , Ur^Fp       , Ur          , Ur          , Hh^Fdw      , Gs^Fp       , Gs^Fp       , Ww          , Wo          , Wo          , Wo          , Ss^Fp       , Ss^Fp       , Re          , Ss          , Ss^Fp       , Ur          , Ss          , Ss^Fp       , Re          , Re          , Gg^Ve       , Re          , Re          , Ce          , Re          , Re          , Gg          , Gg          , Gg          , Gs^Fp       , Gg          , Gg          , Ss          , Gs^Fp       , Ur          , Ur          , Ss          , Ss          , Hh^Fp       , Gs^Fp       , Ss          , Ur          , Ss          , Gs^Fp       
Uu^Fp       , Ur^Fp       , Ur          , Ur          , Gs^Fp       , Gs^Fp       , Gs^Fp       , Gs^Fp       , Gs^Fp       , Wo          , Wo          , Ss^Fp       , Ss          , Re          , Ss          , Re          , Re          , Re          , Re          , Re          , Ss^Fp       , Ss^Fp       , Ce          , Ce          , Ce          , Re          , Ce          , Ce          , Ce          , Gg^Vh       , Gg          , Gs^Fp       , Gs^Fp       , Gs^Fp       , Gs^Fmw      , Hh^Fmw      , Gs^Fdw      , Gs^Fmw      , Ss          , Ur          , Ur          , Ur          , Ss          , Gs^Fmw      , Gs^Fmw      , Gs^Fmw      
Uu          , Ur          , Ur          , Hh^Fp       , Ur          , Ur          , Ur          , Ss          , Ss          , Wo          , Wo^Bw/      , Re          , Re          , Re          , Ss^Fp       , Ss^Fp       , Ss^Fp       , Ss^Fp       , Ss          , Ss^Fp       , Ss^Fp       , Ss^Fp       , Ce          , 1 Ke^Ii     , Ce          , Re          , Ce          , 3 Ke^Ii     , Ce          , Gs^Fp       , Gg          , Hh^Fp       , Gs^Fp       , Gg          , Gs^Fmw      , Gs^Fmw      , Gs^Fdw      , Gs^Fdw      , Gs^Fdw      , Gs^Fmw      , Hh^Fdw      , Gs^Fmw      , Gs^Fmw      , Hh^Fp       , Gs^Fmw      , Gs^Fmw      
Re          , Ur          , Gs^Fp       , Gs^Fp       , Gs^Fp       , Hh^Fp       , Re          , Gs^Fp       , Re          , Wo^Bw/      , Wo          , Ur          , Ss^Fp       , Ur          , Ur          , Gg^Vo       , Gs^Fdw      , Gs^Fdw      , Gs^Fdw      , Ss^Fp       , Re          , Re          , Ss^Fp       , Ce          , Wo          , Wo          , Wo          , Ce          , Gs^Fp       , Gs^Fp       , Gs^Fp       , Gg          , Gg          , Gs^Fp       , Gs^Fmw      , Ss          , Gs^Fdw      , Gs^Fdw      , Gs^Fdw      , Hh^Fdw      , Gg          , Ur          , Ur          , Gs^Fmw      , Gs^Fmw      , Gs^Fmw      
Re          , Re          , Re          , Re          , Re          , Re          , Gs^Fp       , Re          , Ds          , Wo          , Wo          , Ss          , Ss^Fp       , Ss^Fp       , Ss^Fp       , Ur          , Gs^Fdw      , Hh^Fdw      , Re          , Ss^Fp       , Re          , Ss^Fp       , Wo          , Ww^Vm       , Wo          , Wo          , Wo          , Wo          , Wo          , Gg          , Gs^Fp       , Gs^Fp       , Gg          , Gs^Fp       , Gs^Fmw      , Gg          , Gg^Uf       , Gs^Fdw      , Gs^Fmw      , Gs^Fmw      , Gg^Vc       , Gs^Fmw      , Ur^Fp       , Gs^Fmw      , Ss          , Gs^Fmw      
Gs^Fp       , Gs^Fp       , Ur          , Gs^Fp       , Ur          , Gs^Fp       , Gs^Fp       , Ur          , Ds          , Wo          , Wo          , Ss          , Ss          , Ss^Fp       , Ss^Fp       , Gs^Fdw      , Ss^Fp       , Re          , Ss          , Re          , Wo          , Wo^Bw\      , Wo^Bw\      , Wo          , Ss          , Ds          , Ds          , Wo          , Wo          , Wo          , Wo          , Gs^Fp       , Ss          , Gg          , Gg          , Gs^Fmw      , Ss          , Gs^Fmw      , Hh^Fp       , Gs^Fmw      , Ss          , Gg          , Ur          , Gs^Fp       , Gs^Fp       , Ss          
Gs^Fp       , Gs^Fp       , Gs^Fp       , Ur          , Ur          , Ur          , Ur          , Gs^Fmw      , Ur          , Wo          , Wo          , Ds          , Ur          , Ss^Fp       , Ss^Fp       , Ss^Fp       , Re          , Re          , Ss^Fp       , Wo          , Wo          , Wo          , Ss          , Gg          , Ss^Fp       , Ss          , Ss^Fp       , Ds          , Ds          , Wo          , Wo          , Wo          , Wo          , Gg          , Gg          , Gs^Fmw      , Gg          , Gg          , Ss          , Gs^Fp       , Hh^Fp       , Gs^Fp       , Ur^Fp       , Gs^Fp       , Gs^Fp       , Gs^Fp       
Gs^Fmw      , Gs^Fp       , Gs^Fp       , Ss          , Gs^Fp       , Gs^Fp       , Ur          , Gs^Fmw      , Wwf         , Wo          , Wo          , Ds          , Ur          , Ss^Fp       , Ss^Fp       , Ss^Fp       , Re          , Ss^Fp       , Wo          , Wo          , Wo          , Ss^Fp       , Ss          , Gg          , Gg          , Gg          , Gg          , Gs^Fdw      , Ss^Fp       , Gg          , Ss^Fp       , Wo          , Wo          , Wo          , Wo^Bw/      , Gg          , Gs^Fp       , Gs^Fp       , Gs^Fp       , Gs^Fp       , Gs^Fp       , Gs^Fp       , Ur          , Ur          , Ur          , Gs^Fp       
Gs^Fp       , Gs^Fmw      , Gs^Fmw      , Gs^Fp       , Hh^Fmw      , Gs^Fp       , Ur          , Gs^Fmw      , Ss          , Wo          , Wo          , Ds          , Ss^Fp       , Ss^Fp       , Re          , Re          , Re          , Ss^Fp       , Wo          , Wo          , Wo          , Ss^Fp       , Ss          , Gg          , Ss^Fp       , Hh^Fdw      , Gs^Fdw      , Gg          , Ss          , Ss^Fp       , Ss          , Ss          , Gg          , Wo^Bw/      , Wo          , Wo          , Wo          , Gs^Fp       , Gg          , Gs^Fp       , Gs^Fp       , Ss          , Ur          , Gs^Fp       , Ur          , Gs^Fp       
Gs^Fmw      , Gs^Fmw      , Gs^Fmw      , Ur          , Gs^Fmw      , Gs^Fmw      , Ur          , Gs^Fmw      , Gs^Fmw      , Wo          , Wo          , Ss^Fp       , Re          , Re          , Ss^Fp       , Ss^Fp       , Wo          , Wo^Bw\      , Wo^Bw\      , Wo          , Ss^Fp       , Ss^Fp       , Re          , Gg          , Ss          , Gs^Fdw      , Ur          , Gg          , Gg          , Hh^Fp       , Gg          , Ss^Fp       , Ss          , Gg          , Gs^Fp       , Wo          , Wo          , Wo          , Ss^Fdw      , Ss          , Ur^Fp       , Ur          , Gs^Fp       , Ss          , Ur          , Gs^Fp       
Gs^Fmw      , Ur          , Ur          , Ur^Fmw      , Gs^Fmw      , Ur          , Ss          , Hh^Fmw      , Gs^Fmw      , Wo          , Wo          , Wo          , Re          , Ss^Fp       , Wo          , Wo          , Wo          , Wo          , Ss^Fp       , Gg          , Gg          , Re          , Hh^Fp       , Hh          , Hh          , Gs^Fp       , Gg          , Gs^Fp       , Gs^Fp       , Gg          , Hh^Fdw      , Gg          , Gg          , Gs          , Gs          , Gg          , Wo          , Wo          , Ss^Fdw      , Ss          , Ss          , Ur          , Ur          , Gs^Fp       , Gs^Fp       , Ur          
Gs^Fmw      , Gs^Fmw      , Gs^Fmw      , Gs^Fmw      , Gs          , Gs^Fmw      , Gs^Fmw      , Gs^Fmw      , Re          , Wo          , Wo^Bw/      , Wo^Bw/      , Wo          , Wo          , Wo          , Wo          , Ds          , Ds          , Gg          , Ss^Fp       , Gg          , Ur          , Hh^Uf       , Wwf         , Gs^Fp       , Gs^Fp       , Gg          , Gg          , Gg          , Gg          , Ss^Fp       , Ss^Fp       , Gs          , Gs          , Ss          , Ds          , Wo          , Wo          , Ss^Vm       , Ss^Fdw      , Ur          , Ur^Fp       , Ss          , Hh^Fp       , Gs^Fp       , Ur          
Gs^Fmw      , Gs          , Gs^Fmw      , Gs^Fmw      , Gs^Vht      , Gs          , Gs          , Gs^Fdw      , Hh^Fdw      , Re          , Ss          , Wo          , Wo          , Wo          , Dd^Vda      , Dd^Dc       , Ds          , Ss          , Ur^Fdw      , Re          , Ur          , Ur          , Ur^Fdw      , Wwf         , Wwf         , Gs^Vht      , Gs^Fp       , Gg          , Ss^Fp       , Ss          , Wo          , Wo          , Wo          , Gs          , Wo^Bw\      , Ds          , Wo          , Wo          , Ss^Fdw      , Ss^Fdw      , Ur^Fp       , Ss          , Gs^Fp       , Gs^Fp       , Ur          , Ur          
Gs^Fdw      , Gs^Fdw      , Hh^Fdw      , Gs^Fdw      , Gs          , Gs^Fdw      , Gs^Fdw      , Gs^Fdw      , Gs^Fdw      , Re          , Gs          , Ss          , Ss          , Ss          , Ds          , Ds          , Ur^Fdw      , Uh^Fdw      , Re          , Gg          , Ur          , Ur^Fdw      , Ur^Fdw      , Ur^Fdw      , Ss          , Wwf         , Gg          , Gg          , Wo          , Wo          , Wo          , Wo          , Wo          , Wo          , Wo          , Wo^Bw\      , Re          , Ss          , Gs^Fp       , Gs^Fp       , Ur          , Ur          , Ss          , Hh^Fp       , Gs^Fp       , Gs^Fp       
Gs^Fdw      , Gs          , Gs^Fdw      , Gs^Fdw      , Gs^Fdw      , Gs^Fdw      , Hh^Vhh      , Gs          , Gs^Fdw      , Gs^Fdw      , Gs^Fdw      , Gs          , Ss          , Ss          , Uh          , Ur^Fdw      , Ur          , Ur^Fdw      , Gg          , Chs^Uf      , Ur^Fdw      , Ur          , Ss^Uf       , Ss          , Ds          , Wwf         , Wwf         , Wo^Bw|      , Wo          , Wo          , Ss          , Ss^Fdw      , Gs^Fmw      , Wo          , Ss          , Ss          , Gs^Fdw      , Re          , Re          , Re          , Re          , Gs^Fp       , Gs^Fp       , Ss          , Hh^Fp       , Gs^Fp       
Gs^Fdw      , Gs^Fdw      , Gs^Fdw      , Gs          , Gs^Fdw      , Gs^Fdw      , Gs^Fdw      , Gs^Fdw      , Gs^Fdw      , Gs^Fdw      , Gs^Fdw      , Gs          , Gs          , Ur          , Ur          , Ur          , Gg          , Gg          , Uh          , Uu          , Uu          , Ur          , Ur^Fdw      , Ss^Uf       , Ds          , Wo          , Wo          , Wo^Bw|      , Re          , Gs^Fp       , Ss          , Ss^Fdw      , Ss^Fdw      , Gs^Fmw      , Gs^Fdw      , Ss^Fdw      , Gs^Fdw      , Ur^Fdw      , Gs^Fdw      , Gs^Fdw      , Re          , Re          , Chr         , Gs^Fp       , Gs^Fp       , Gs^Fp       
Gs^Fdw      , Gs^Fdw      , Chr         , Chr         , Chr         , Gs^Fdw      , Gs          , Hh^Fdw      , Gs^Fdw      , Gs^Uf       , Gs^Fdw      , Hh^Uf       , Uh          , Ur          , Uu          , Uu          , Re          , Uu          , Xu          , Ur^Uf       , Uu          , Ur          , Ur          , Uh          , Dd          , Ds          , Wo          , Re          , Re          , Gs^Fp       , Gs^Fp       , Ss          , Ss^Fdw      , Hh^Fmw      , Gs^Fdw      , Gs^Fdw      , Gs^Fdw      , Gs^Fdw      , Uu^Uf       , Hh^Vhh      , Re          , Chr         , 5 Khr^Ii    , Chr         , Gs^Fdw      , Gs^Fdw      
Gs^Fdw      , Gs^Fdw      , Chr         , 6 Khr^Ii    , Chr         , Gs^Fdw      , Gs          , Gs^Fdw      , Gs          , Gs          , Hh^Fdw      , Gs^Fdw      , Ur^Fdw      , Uu          , Ur^Fdw      , Xu          , Uu^Vud      , Uu^Ufi      , Xu          , Ur^Fdw      , Uu          , Ur          , Dd          , Ur^Fdw      , Dd          , Ds          , Wo          , Gs^Fp       , Re          , Re          , Gs^Fp       , Ss          , Ss^Fdw      , Ss^Fdw      , Gs^Fdw      , Ur^Fdw      , Gs^Fdw      , Hh^Fdw      , Ur^Fdw      , Gs^Fdw      , Gs^Fdw      , Chr         , Chr         , Chr         , Gs^Fdw      , Gs^Fdw      
Gs^Fdw      , Gs^Fdw      , Gs^Fdw      , Chr         , Gs^Fdw      , Gs^Fdw      , Gs^Fdw      , Gs^Fdw      , Gs^Fdw      , Gs          , Ur^Fdw      , Ur^Fdw      , Uu          , Uu          , Ur^Fdw      , Xu          , Xu          , Uu          , Uh          , Uh          , Uu^Uf       , Ur^Fdw      , Ds          , Dd          , Ds          , Wo          , Wo          , Gs^Fp       , Gs^Fp       , Re          , Gs^Fp       , Gs^Fp       , Gs^Fmw      , Hh^Fmw      , Gs^Fmw      , Gs^Fdw      , Gs^Fdw      , Gs^Fdw      , Gs^Fdw      , Gs^Fdw      , Gs^Fdw      , Gs^Fdw      , Gs^Fdw      , Gs^Fdw      , Gs^Fdw      , Gs^Fdw      
Gs^Fdw      , Gs^Fdw      , Gs^Fdw      , Gs^Fdw      , Gs^Fdw      , Gs          , Gs^Fdw      , Gs^Fdw      , Ur^Fdw      , Ur^Uf       , Uu          , Ur^Fdw      , Uu          , Ur^Fdw      , Ur^Fdw      , Xu          , Xu          , Uu          , Uu          , Uh          , Xu          , Dd          , Dd^Fp       , Dd^Fp       , Dd          , Wo          , Wo          , Gs^Fp       , Gs^Fp       , Re          , Re          , Gs^Fp       , Gs^Fmw      , Gs^Fmw      , Gs^Fmw      , Gs^Fdw      , Gs^Fdw      , Gs^Fdw      , Gs^Fdw      , Gs^Fdw      , Gs^Fdw      , Gs^Fdw      , Gs^Fdw      , Gs^Fdw      , Gs^Fdw      , Gs^Fdw      
