border_size=1
usage=map

Gs^Fdw      , Gs^Fmw      , Gs^Fdw      , Gs^Fp       , Gs^Fmw      , Gs^Fdw      , Hh^Fmw      , Re          , Ss^Fdw      , Gs^Fmw      , Ss          , Gs^Fdw      , Ss^Fmw      , Ss          , Ss          , Hh^Fms      , Ss^Fdw      , Ss^Fdw      , Ss^Fp       , Hh^Fms      , Ss^Fp       , Hh^Fms      , Ss^Fdw      , Gs^Fms      , Ss^Fdw      , Gs^Fp       , Ss^Fdw      , Hh^Fdw      , Hh^Fdw      , Hh^Fms      , Ss^Fdw      , Gs^Fp       
Gs^Fms      , Gs^Fdw      , Ss          , Hh          , Hh^Fmw      , Hh          , Ss          , Ss          , Ss^Fdw      , Ss          , Ss          , Hh^Fdw      , Ss^Fdw      , Ss          , Ss          , Hh^Fms      , Ss^Uf       , Ss          , Re^Vct      , Ss^Fdw      , Ss^Fdw      , Ss          , Ss          , Ss^Fdw      , Ss^Fms      , Ss^Fdw      , Ss^Uf       , Gs^Fms      , Ss^Fdw      , Hh^Fdw      , Ss^Fdw      , Hh^Fms      
Hh^Fmw      , Gs^Fdw      , Hh          , Ss          , Ur          , Ur          , Ss^Fmw      , Ss^Fmw      , Ss^Fmw      , Ss          , Gs^Uf       , Ss^Fdw      , Wwf         , Ss^Vm       , Ss          , Hh^Fdw      , Ss          , Ss          , Ss^Fms      , Ss^Fdw      , Ur          , Ss^Fms      , Ss^Fms      , Ss^Fp       , Ur          , Re^Vct      , Cud         , Cud         , Cud         , Ss^Fdw      , Gs^Fms      , Hh^Fms      
Gs^Fp       , Hh^Fdw      , Ss^Uf       , Hh^Fp       , Re          , Ss^Fmw      , Ss          , Ss          , Ss          , Ss^Fmw      , Re          , Ss^Fdw      , Ss^Fdw      , Ss          , Ss          , Re          , Re          , Ur          , Ss          , Re          , Ss^Fdw      , Ur          , Chr         , Ur          , Hh          , Ss^Uf       , Cud         , Cud         , 4 Kud^Ii    , Cud         , Ss^Uf       , Hh^Fms      
Re          , Re          , Ur          , Gs^Fmw      , Ss          , Ss^Fmw      , Ss^Fdw      , Gs^Fdw      , Ss^Fmw      , Ss^Fmw      , Re^Vct      , Ur          , Gs^Fp       , Ss          , Wwf         , Ss^Fdw      , Ss^Fmw      , Ss^Fdw      , Ss          , Ss^Fdw      , Ss^Fdw      , Re          , Ss          , Re          , Ur          , Cud         , Cud         , Cud         , Cud         , Cud         , Re^Vct      , Hh^Fdw      
Gs^Fp       , Gs^Fms      , Ur          , Ss          , Ss^Fmw      , Ss^Fmw      , Hh^Fp       , Ss^Fdw      , Ss^Fmw      , Ss^Fmw      , Gs          , Ur          , Gs^Fp       , Wwf         , Ss          , Wwf         , Ss^Fmw      , Hh          , Gs^Uf       , Ss          , Ss^Fdw      , Ss^Fdw      , Gs^Fmw      , Ss^Fdw      , Ss^Fdw      , Ss^Uf       , Ss^Uf       , Ss^Uf       , Ur          , Ss^Uf       , Ss^Fms      , Ss^Fp       
Gs^Uf       , Ss^Fdw      , Ss          , Gg          , Ur          , Ss^Vhs      , Ss          , Ss          , Ss^Fmw      , Re          , Gs^Fmw      , Hh          , Wwf         , Ss          , Wwf         , Ds          , Ss^Fmw      , Mm          , Hh^Fmw      , Gs          , Gs          , Hh          , Gs          , Gs^Fmw      , Hh^Fmw      , Ss^Fdw      , Gs^Fmw      , Re          , Ur          , Ss^Fms      , Ss^Fms      , Ss^Fp       
Gs^Fp       , Ss          , Ss^Fms      , Re          , Re          , Gs^Fmw      , Gs^Fmw      , Re          , Ss          , Ss          , Gs^Uf       , Gs^Fp       , Wwf         , Ss          , Ss^Uf       , Ds          , Hh^Fdw      , Hh^Fdw      , Ur          , Gs^Fmw      , Gs^Fmw      , Gs^Fmw      , Gs^Fmw      , Gs^Fmw      , Ss^Fdw      , Gs          , Gs^Fmw      , Hh^Fmw      , Gs^Fdw      , Ur          , Ss^Fms      , Ss^Fp       
Gs^Uf       , Ss          , Gs^Uf       , Ss^Fms      , Ss^Fms      , Ss          , Gs^Fmw      , Gs^Fmw      , Ss          , Uu^Uf       , Ss^Fp       , Gs^Fp       , Ww^Bw/      , Khw         , Ss          , Hh^Vc       , Ss          , Ur          , Hh^Fdw      , Ur          , Uu^Uf       , Hh^Fmw      , Ss          , Ss          , Ss          , Gs^Fmw      , Ss^Uf       , Ss^Uf       , Re          , Ss          , Ss^Fms      , Ss^Fp       
Gs^Fp       , Gs^Fp       , Ss^Fms      , Ss^Fms      , Ss          , Ss          , Gs^Fmw      , Ss          , Ss^Fmw      , Ss^Fmw      , Ss^Fp       , Ur          , Ww          , Chs         , Ss          , Ur          , Gs^Fmw      , Hh^Fmw      , Mm          , Hh          , Re          , Ss^Vhs      , Ss          , Ss          , Ss          , Gs^Fmw      , Ss^Uf       , Hh^Fdw      , Ss^Fms      , Ss^Fms      , Gs          , Ss^Fp       
Ss^Fms      , Ss^Fms      , Ss^Fms      , Gs          , Gs^Fms      , Re          , Gs^Fmw      , Ss^Fmw      , Ss^Fms      , Ss^Fms      , Ss^Fp       , Gs          , Wwf         , Wwf         , Ss          , Re          , Ur          , Uu^Uf       , Ur          , Ur          , Re          , Ss          , Ss^Fdw      , Gs^Fmw      , Ss          , Ss          , Gs^Fdw      , Hh^Fdw      , Ss^Fmw      , Ss^Fmw      , Gs          , Ss^Fp       
Ss^Fms      , Ce          , Re          , Ur          , Ur          , Gg          , Hh^Uf       , Hh^Fms      , Ss^Fdw      , Ss^Fp       , Ss^Fp       , Re          , Hh^Fdw      , Wwf         , Ss          , Re          , Ss^Uf       , Hh^Fp       , Hh          , Uu^Uf       , Ss          , Re          , Gs^Fmw      , Hh^Fdw      , Ur          , Gs^Fdw      , Hh^Fms      , Ss          , Ss^Fms      , Gs          , Ss^Uf       , Ss^Uf       
Ss^Fms      , Ce          , Re          , Re^Vct      , Gs^Fms      , Hh^Fdw      , Ss^Fdw      , Gs^Fdw      , Ss          , Gs^Fmw      , Gs^Fdw      , Gs          , Ur          , Wwf         , Ss          , Re          , Gs^Fms      , Gs^Fms      , Ur          , Gs^Vht      , Ss          , Ur          , Re          , Ur          , Ss^Uf       , Ss^Uf       , Ss^Fdw      , Ss          , Ss^Uf       , Ss^Uf       , Ss^Uf       , Hh^Fms      
Ss^Fms      , Ce          , Re          , Gs^Fms      , Gs^Fdw      , Hh^Fdw      , Ss^Fdw      , Ss          , Ss          , Ss^Vhs      , Ss^Fdw      , Ss^Fp       , Re          , Ss          , Re          , Ss          , Gs^Fmw      , Gs^Fms      , Gs^Fms      , Gs          , Gs^Fms      , Ur          , Hh^Fms      , Gs^Fmw      , Ss          , Ss^Fdw      , Ss          , Ss^Uf       , Gs          , Ss          , Hh^Fms      , Hh^Fms      
Ss^Fms      , Ce          , Re          , Gs^Fdw      , Ss^Uf       , Ss          , Ss^Fdw      , Gs          , Ss^Fdw      , Ss          , Ss^Fdw      , Ur          , Re          , Ss          , Wwf         , Gs^Fmw      , Gs^Fdw      , Ss          , Ss          , Ss          , Gs^Fdw      , Ur          , Ss          , Gs^Fms      , Ss^Fdw      , Ss^Fdw      , Ss^Fdw      , Ss^Fdw      , Hh^Fms      , Gs^Vht      , Ur          , Gs^Fp       
Ss^Fms      , Ce          , Re          , Gs^Fdw      , Ss          , Gs^Fdw      , Ur          , Ss^Fdw      , Ss          , Ss^Fdw      , Ur          , Ss          , Ss^Fdw      , Ss          , Ss          , Hh^Fmw      , Ds          , Ss          , Gs^Fmw      , Gs^Fmw      , Gs^Fp       , Gs^Fdw      , Ss          , Gs          , Ss^Fdw      , Ss^Fdw      , Ss^Fdw      , Ur          , Cud         , Ur          , Ss^Fdw      , Ss^Fdw      
Gs^Fp       , 2 Ke^Ii     , Ss          , Ss          , Re          , Re          , Gs          , Ur          , Ss^Fdw      , Ur          , Ss^Fmw      , Re^Vct      , Ss^Fdw      , Ds          , Dd^Vda      , Ss          , Ds          , Ur^Fmw      , Chr         , Gs^Fmw      , Uu^Uf       , Gg^Vc       , Gs^Fmw      , Ss          , Ss^Fdw      , Ss^Uf       , Ur          , Ss^Fdw      , Cud         , Cud         , Ss^Fdw      , Ss^Fdw      
Re          , Re          , Ce          , Ce          , Ce          , Ce          , Re          , Re          , Hh          , Ss^Fdw      , Hh          , Ss^Fdw      , Hh^Fp       , Ss^Fp       , Ds          , Ss          , Ds          , Ur^Fdw      , Ur          , Ur^Fdw      , Ur^Fdw      , Gs^Fmw      , Gs^Fdw      , Gs          , Ss          , Gs          , Ss          , Ss^Fdw      , Cud         , 5 Khs       , Ss^Fdw      , Gs^Fp       
Re          , Re          , Ce          , 3 Ke^Ii     , Ce          , 1 Ke^Ii     , Ce          , Ur          , Ss^Fp       , Ss^Fdw      , Re          , Ss^Fmw      , Uu          , Ur          , Ds          , Wwf         , Ss^Uf       , Ur          , Ur^Fdw      , Ur^Uf       , Ur          , Ss          , Gs^Fmw      , Gs          , Gs          , Ss^Fdw      , Ss^Fms      , Gs          , Cud         , Ur          , Ur          , Gs^Fp       
Re          , Gs^Fdw      , Ce          , Ce          , Ss^Fmw      , Ce          , Ur          , Ur          , Ur          , Ur          , Uu          , Uu          , Xu          , Uh          , Ur          , Wwf         , Ur          , Ur          , Uh^Fdw      , Ur^Fdw      , Ur^Uf       , Ss          , Ur          , Ur          , Ur          , Ss^Fdw      , Ss^Fms      , Gs          , Cud         , Cud         , Ss^Fdw      , Gs^Uf       
Gs^Fdw      , Gs^Fdw      , Uu^Uf       , Uu^Uf       , Ss^Fms      , Ss^Fmw      , Ur^Uf       , Ur          , Uu^Vu       , Xu          , Xu          , Uu          , Xu          , Uu          , Uu^Uf       , Ss          , Uh          , Uh^Uf       , Qxu^Bs\     , Xu          , Uh^Fdw      , Ur^Fdw      , Ur^Fdw      , Gs^Fmw      , Gs^Fmw      , Ur          , Ur          , Ss          , Ur          , Cud         , Gs^Uf       , Ss^Fms      
Ss^Fmw      , Ss^Fmw      , Ss^Fmw      , Ss^Fmw      , Ss^Fmw      , Ss^Fmw      , Ss^Fmw      , Ur^Uf       , Ur^Uf       , Uh          , Xu          , Ss^Fdw      , Qxu         , Qxu^Bs|     , Uu^Fdw      , Ss          , Ur^Fdw      , Xu          , Xu          , Xu          , Uh^Uf       , Uh^Uf       , Uh^Uf       , Ur^Fdw      , Gs^Fmw      , Gs^Fms      , Gs^Fmw      , Gs^Uf       , Ss^Fms      , Ss^Fms      , Gs^Uf       , Gs^Uf       
