border_size=1
usage=map

Mm          , Mm          , Mm          , Mm          , Mm          , Hh          , Ha^Fpa      , Hh          , Gs^Fmf      , Gg          , Gg          , Gg          , Gg          , Gg          , Gg          , Gg          , Gg          , Gg          , Gg          , Gg          , Gg          , Gg          
Mm          , Mm          , Mm          , Hh^Vhh      , Ha^Fpa      , Hh          , Hh          , Hh          , Gg          , Gg          , Gg          , Gg          , Gg^Vo       , Gg          , Gs^Fmf      , Gg          , Ce          , Ce          , Ce          , Ce          , Ce          , Gg          
Mm          , Mm          , Ms          , Ms          , Mm          , Hh          , Ss          , Gg          , Hh^Fdf      , Ss          , Gg          , Ss          , Ss          , Gg          , Gg          , 6 Ke        , Wo          , Wo          , Wo          , Ce          , Wo          , Wo          
Ms          , Mm          , Ms          , Mm          , Hh          , Hh          , Ss          , Ss          , Gg          , Hh^Fp       , Ss          , Ss          , Gg          , Gg          , Gg          , Wwf         , Ce          , Ce          , Ce          , Wo          , Gg          , Gg          
Mm          , Ha^Fpa      , Ha^Fpa      , Hh          , Ss          , Gg          , Hh^Fp       , Gs^Fp       , Gs^Fmf      , Gg          , Hh^Fp       , Gs^Fp       , Gs^Fmf      , Gs^Fmf      , Gg          , Wo          , Ce          , Ce          , Ce          , Ce          , Gg          , Gg          
Mm          , Ms          , Cud         , Ha^Fpa      , Ss          , Gg          , Gg          , Gs^Fmf      , Hh^Fms      , Gs^Fp       , Gg          , Ss          , Re          , Re          , Wo^Bw\      , Wo          , Re          , Ce          , Gg          , 5 Ke        , Re          , Re          
Mm          , Cud         , 7 Kud       , Cud         , Hh          , Ss          , Gg          , Gs^Fmf      , Hh^Fp       , Gs^Fp       , Re          , Re          , Wo          , Wwf         , Ww          , Re          , Gg          , Re          , Re          , Re          , Gg          , Gg          
Mm          , Cud         , Hh          , Cud         , Hh^Fms      , Ss^Vhs      , Gs^Fp       , Re          , Re          , Re          , Hh          , Hh          , Wo          , Gg          , Hh          , Ww          , Ww          , Ww          , Wwf^Bw\     , Re^Vct      , Ww          , Ww          
Hh          , Uu^Uf       , Hh          , Hh          , Hh^Fms      , Gs^Fp       , Re          , Re          , Hh          , Hh^Fp       , Ww          , Ww          , Mm^Xm       , Hh          , Hh          , Hh^Fmf      , Hh          , Gs^Fds      , Re          , Ww          , Gg          , Gg          
Gg          , Gg          , Gg          , Ss          , Gg          , Re          , Gg          , Hh          , Ww          , Ww          , Ms          , Ms          , Mm^Xm       , Hh^Fp       , Mm          , Hh          , Mm          , Hh          , Re          , Hh^Fdf      , Gg          , Gs^Fmf      
Gg          , Gg          , Gg          , Gs^Fmf      , Re          , Re          , Gs^Fmf      , Hh          , Ww          , Hh^Fmw      , Ms          , Mm^Xm       , Mm          , Mm^Vhh      , Hh^Fdw      , Mm^Xm       , Hh          , Hh          , Re          , Gg          , Gs^Fmf      , Gg          
Gg          , Gg^Ve       , Gs^Fmf      , Gg          , Re          , Gg          , Gg          , Hh          , Ww          , Ms          , Qlf         , Mm          , 4 Khr       , Chr         , Ch          , Ha^Fpa      , Ha^Fpa      , Hh          , Re          , Gg          , Gg          , Gg          
Gg          , Gg          , Gg          , Re          , Gs^Fmf      , Gg          , Hh          , Hh          , Ww          , Ww          , Mm^Xm       , Mm^Xm       , Chr         , Ch          , Mm          , Ms          , Hh^Fdw      , Hh^Vc       , Re          , Hh^Fdf      , Gs^Fds      , Gg          
Xu          , Xu          , Xu          , Re          , Xu          , Gg          , Gg          , Hh          , Ww          , Mm          , Mm^Vhh      , Mm          , Mm^Xm       , Mm          , Gg          , Ms          , Mm          , Hh          , Re          , Gg          , Gg          , Gg          
Ce          , Ce          , 2 Ke        , Gg          , Xu          , Hh          , Wo^Bw|      , Wo          , Hh          , Mm          , Mm          , Mm          , Mm          , Mm          , Hh          , Mm          , Hh          , Hh^Fmf      , Re          , Gg          , Gs^Fds      , Gg          
Ce          , Ce          , Ce          , Xu          , Ww          , Ww          , Gg          , Hh          , Gg          , Gs^Fmf      , Hh          , Hh^Fmw      , Hh          , Gs^Fmf      , Gg          , Hh          , Re          , Re          , Gg          , Gg          , Gg          , Gg          
Uu          , Ce          , Wo          , Wwf         , Ce          , Xu          , Gg          , Gg          , Gg          , Gg          , Hh          , Hh          , Gg          , Gg          , Re          , Re          , Hh^Fmf      , Gs^Fds      , Gg          , Gg          , Gg          , Gg          
Uu          , Uu          , Wo          , Ce          , Ce          , Xu          , Xu          , Gg          , Gg          , Gg          , Gg          , Gg          , Re          , Re          , Re          , Gg          , Gg          , Gg          , Gg          , Gg^Vh       , Gg          , Gg          
Ww          , Ww          , Uu          , Ce          , Ce          , Ce          , Uu          , Gg          , Re          , Re          , Re          , Re          , Gg          , Gg          , Gg          , Gs^Vht      , Gg          , Gg          , Gg          , Gg          , Gg          , Gg          
Wo          , Uu          , Uu          , Uu^Uf       , Uu^Vu       , 1 Ke        , Ce          , Uu          , Xu          , Gg          , Gg          , Hh^Fmf      , Gg          , Gg          , Gg          , Gg          , Gg          , Gg          , Gg          , Gg          , Gg          , Gg          
Uu          , Uu^Vud      , Uu          , 3 Ke        , Ce          , Ce          , Ce          , Ce          , Xu          , Gg          , Gg          , Gg          , Gg          , Gg          , Gg          , Gg          , Gg^Vc       , Gg          , Gg          , Gg          , Gg          , Gg          
Uu          , Uu          , Uu          , Uu          , Uu          , Uu          , Uu          , Ce          , Xu          , Gg          , Gg          , Gg          , Gg          , Gg          , Gg          , Gg          , Gg          , Gg          , Gg          , Gg          , Gg          , Gg          
