border_size=1
usage=map

Ur          , Ur          , Ur          , Ur          , Ur          , Ur          , Ur          , Ur          , Ur          , Ur          , Ur          , Ur          , Ur          , Ur          , Xu          , Uu          , Ww          , Uu          , Xu          , Ur          , Ur          , Ur          , Ur          , Ur          , Ur          , Ur          , Ur          , Ur          , Ur          , Ur          , Ur          , Ur          
Ur          , Ur          , Ur          , Ur          , Ur          , Ur          , Ur          , Ur          , Ur          , Ur          , Ur          , Ur          , Ur          , Ur          , Xu          , Uu          , Ww          , Uu          , Xu          , Ur          , Ur          , Ur          , Ur          , Ur          , Ur          , Ur          , Ur          , Ur          , Ur          , Ur          , Ur          , Ur          
Ur          , Ur          , Ur          , Ur          , Ur          , Ur          , Ur          , Ur          , Ur          , Ur          , Ur          , Ur          , Ur          , Ur          , Xu          , Uu          , Ww          , Uu          , Xu          , Ur          , Ur          , Ur          , Ur          , Ur          , Ur          , Ur          , Ur          , Ur          , Ur          , Ur          , Ur          , Ur          
Ur          , Ur          , Ur          , Ur          , Ur          , Ur          , Ur          , Ur          , Ur          , Ur          , Ur          , Ur          , Ur          , Ur          , Xu          , Uu          , Ww          , Uu          , Xu          , Ur          , Ur          , Ur          , Ur          , Ur          , Ur          , Ur          , Ur          , Ur          , Ur          , Ur          , Ur          , Ur          
Ur          , Ur          , Ur          , Ur          , Ur          , Ur          , Ur          , Ur          , Ur          , Ur          , Ur          , Ur          , Ur          , Ur          , Xu          , Uu          , Ww          , Uu          , Xu          , Ur          , Ur          , Ur          , Ur          , Ur          , Ur          , Ur          , Ur          , Ur          , Ur          , Ur          , Ur          , Ur          
Ur          , Ur          , Ur          , Ur          , Ur          , Ur          , Ur          , Ur          , Ur          , Ur          , Ur          , Ur          , Ur          , Ur          , Ur          , Cud         , Ww          , Cud         , Ur          , Ur          , Ur          , Ur          , Ur          , Ur          , Ur          , Ur          , Ur          , Ur          , Ur          , Ur          , Ur          , Ur          
Ur          , Ur          , Ur          , Ur          , Ur          , Ur          , Ur          , Ur          , Ur          , Ur          , Ur          , Ur          , Ur          , Ur          , Ur          , Ur          , Ww          , Ur          , Ur          , Ur          , Ur          , Ur          , Ur          , Ur          , Ur          , Ur          , Ur          , Ur          , Ur          , Ur          , Ur          , Ur          
Ur          , Ur          , Ur          , Ur          , Ur          , Ur          , Ur          , Ur          , Ur          , Ur          , Ur          , Ur          , Ur          , Ur          , Ww^Bw\      , Ww          , Ur          , Ww          , Ww^Bw/      , Ur          , Ur          , Ur          , Ur          , Ur          , Ur          , Ur          , Ur          , Ur          , Ur          , Ur          , Ur          , Ur          
Ur          , Ur          , Ur          , Ur          , Ur          , Ur          , Ur          , Ur          , Ur          , Ur          , Ur          , Ur          , Ur          , Ww          , Ur          , Ur          , Ur          , Ur          , Ur          , Ww          , Ur          , Ur          , Ur          , Ur          , Ur          , Ur          , Ur          , Ur          , Ur          , Ur          , Ur          , Ur          
Ur          , Ur          , Ur          , Ur          , Ur          , Ur          , Wo^Bw\      , Wo          , Wo          , Wo          , Wo          , Wo          , Wo          , Wo          , Wo          , Wo          , Wo^Bw|      , Wo          , Wo          , Wo          , Wo          , Wo          , Wo          , Wo          , Wo          , Wo          , Wo^Bw/      , Ur          , Ur          , Ur          , Ur          , Ur          
Ur          , Ur          , Ur          , Ur          , Ur          , Ur          , Wo          , Kud         , Cud         , Cud         , Cud         , Cud         , Cud         , Cud         , Cud         , Cud         , Cud         , Cud         , Cud         , Cud         , Cud         , Cud         , Cud         , Cud         , Cud         , Kud         , Wo          , Ur          , Ur          , Ur          , Ur          , Ur          
Xu          , Ur          , Ur          , Ur          , Ur          , Ur          , Wo          , Cud         , Ww          , Ww          , Ww          , Ww          , Ww          , Ww          , Ww          , Ww          , Wo^Bw|      , Ww          , Ww          , Ww          , Ww          , Ww          , Ww          , Ww          , Ww          , Cud         , Wo          , Ur          , Ur          , Ur          , Ur          , Ur          
Ur          , Xu          , Xu          , Ur          , Ur          , Ur          , Wo          , Cud         , Ww          , Cud         , Cud         , Cud         , Cud         , Ww          , Cud         , Cud         , Cud         , Cud         , Cud         , Ww          , Cud         , Cud         , Cud         , Cud         , Ww          , Cud         , Wo          , Ur          , Ur          , Ur          , Xu          , Xu          
Ur          , Ur          , Ur          , Cud         , Ur          , Ur          , Wo          , Cud         , Ww          , Cud         , Cud         , Cud         , Cud         , Ww          , Cud         , Cud         , Cud         , Cud         , Cud         , Ww          , Cud         , Cud         , Cud         , Cud         , Ww          , Cud         , Wo          , Ur          , Cud         , Xu          , Ur          , Ur          
Ur          , Ur          , Ur          , Ur          , Ur          , Ur          , Wo^Bw\      , Cud         , Kud         , Cud         , Cud         , Cud         , Cud         , Kud         , Cud         , Cud         , 4 Kud       , Cud         , Cud         , Kud         , Cud         , Cud         , Cud         , Cud         , Kud         , Cud         , Wo^Bw/      , Ur          , Ur          , Ur          , Ur          , Ur          
Ur          , Ur          , Xu          , Cud         , Ur          , Ur          , Wo          , Cud         , Ww          , Cud         , Cud         , Cud         , Cud         , Kud         , Cud         , Cud         , Cud         , Cud         , Cud         , Kud         , Cud         , Cud         , Cud         , Cud         , Ww          , Cud         , Wo          , Ur          , Cud         , Ur          , Ur          , Ur          
Xu          , Xu          , Ur          , Ur          , Ur          , Ur          , Wo          , Cud         , Ww          , Cud         , Cud         , Cud         , Cud         , Ww          , Cud         , Cud         , Cud         , Cud         , Cud         , Ww          , Cud         , Cud         , Cud         , Cud         , Ww          , Cud         , Wo          , Ur          , Ur          , Xu          , Xu          , Ur          
Ur          , Ur          , Ur          , Ur          , Ur          , Ur          , Wo          , Cud         , Ww          , Cud         , Ww          , Cud         , Ww          , Ww          , Ww          , Cud         , Wo^Bw|      , Cud         , Ww          , Ww          , Ww          , Cud         , Ww          , Cud         , Ww          , Cud         , Wo          , Ur          , Ur          , Ur          , Ur          , Xu          
Ur          , Ur          , Ur          , Ur          , Ur          , Ur          , Wo          , Cud         , Cud         , Ww          , Cud         , Ww          , Cud         , Ww          , Cud         , Ww          , Cud         , Ww          , Cud         , Ww          , Cud         , Ww          , Cud         , Ww          , Cud         , Cud         , Wo          , Ur          , Ur          , Ur          , Ur          , Ur          
Ur          , Ur          , Ur          , Ur          , Ur          , Ur          , Wo^Bw/      , Kud         , Wo          , Cud         , Wo          , Cud         , Wo          , Cud         , Wo          , Cud         , Wo^Bw|      , Cud         , Wo          , Cud         , Wo          , Cud         , Wo          , Cud         , Wo          , Kud         , Wo^Bw\      , Ur          , Ur          , Ur          , Ur          , Ur          
Ur          , Ur          , Ur          , Ur          , Ur          , Ur          , Ur          , Wo          , Ur          , Wo          , Ur          , Wo          , Ur          , Wo          , Ur          , Wo          , Ur          , Wo          , Ur          , Wo          , Ur          , Wo          , Ur          , Wo          , Ur          , Wo          , Ur          , Ur          , Ur          , Ur          , Ur          , Ur          
Ur          , Ur          , Ur          , Ur          , Ur          , Ur          , Ur          , Ur          , Ur          , Ur          , Ur          , Ur          , Ur          , Ur          , Ur          , Ur          , Ur          , Ur          , Ur          , Ur          , Ur          , Ur          , Ur          , Ur          , Ur          , Ur          , Ur          , Ur          , Ur          , Ur          , Ur          , Ur          
Ur          , Ur          , Ur          , Ur          , Ur          , Ur          , Ur          , Ur          , Ur          , Ur          , Ur          , Ur          , Ur          , Ur          , Ur          , Ur          , Ur          , Ur          , Ur          , Ur          , Ur          , Ur          , Ur          , Ur          , Ur          , Ur          , Ur          , Ur          , Ur          , Ur          , Ur          , Ur          
Ur          , Ur          , Ur          , Ur          , Ur          , Ur          , Ur          , Ur          , Ur          , Ur          , Ur          , Ur          , Ur          , Ur          , Ur          , Ur          , Ur          , Ur          , Ur          , Ur          , Ur          , Ur          , Ur          , Ur          , Ur          , Ur          , Ur          , Ur          , Ur          , Ur          , Ur          , Ur          
Ur          , Ur          , Ur          , Ur          , Ur          , Ur          , Ur          , Ur          , Ur          , Ur          , Ur          , Ur          , Ur          , Ur          , Xu          , Cud         , Ur          , Cud         , Xu          , Ur          , Ur          , Ur          , Ur          , Ur          , Ur          , Ur          , Ur          , Ur          , Ur          , Ur          , Ur          , Ur          
Ur          , Ur          , Ur          , Ur          , Ur          , Ur          , Ur          , Ur          , Ur          , Ur          , Ur          , Ur          , Ur          , Ur          , Xu          , 1 Ur        , 2 Ur        , 3 Ur        , Xu          , Ur          , Ur          , Ur          , Ur          , Ur          , Ur          , Ur          , Ur          , Ur          , Ur          , Ur          , Ur          , Ur          
Ur          , Ur          , Ur          , Ur          , Ur          , Ur          , Ur          , Ur          , Ur          , Ur          , Ur          , Ur          , Ur          , Ur          , Xu          , Ur          , Ur          , Ur          , Xu          , Ur          , Ur          , Ur          , Ur          , Ur          , Ur          , Ur          , Ur          , Ur          , Ur          , Ur          , Ur          , Ur          
