border_size=1
usage=map

Aa          , Gg          , Gg          , Gg          , Aa          , Gg          , Gg          , Gg          , Aa          , Gg          , Gg          , Gg          , Gg          , Gg          , Gg          , Gg          , Mm^Xm       , Ha^Fda      , Ha^Fda      , Ms          , Ms          , Ms          , Ha          , Ms          , Ha          , Ha^Fda      , Ha^Fda      , Gg          , Ha^Fda      , Gg          , Ha^Fma      , Gg          , Ha^Fma      , Gg          , Aa          , Gg          , Ha^Fma      , Ha^Fma      , Aa          , Hh          , Hh          , Hh          , Mm          , Mm          , Mm          , Mm          , Mm          , Hh          , Ms          , Mm          , Mm          , Mm          , Mm          , Mm          
Gg          , Gg          , Aa          , Gg          , Gg          , Aa          , Gg          , Aa          , Gg          , Aa          , Gg          , Aa          , Gg          , Aa          , Aa^Vca      , Mm^Xm       , Ha^Fda      , Ha^Fda      , Cud         , Cud         , Cud         , Ms          , Mm^Xm       , Aa          , Mm^Xm       , Ha^Fma      , Ha          , Aa          , Ha          , Ai          , Gg          , Ha^Fpa      , Gg          , Aa          , Ai          , Ha^Fpa      , Gg          , Ha^Fma      , Hh          , Hh          , Gg          , Hh          , Hh          , Ms          , Hh          , Gg          , Mm          , Mm          , Mm          , Gg          , Hh          , Mm          , Mm          , Mm          
Gg          , Aa          , Gg          , Gs^Fp       , Gg          , Gg          , Gg          , Gg^Vc       , Re          , Gg          , Gg          , Gs^Fp       , Gg          , Aa          , Gg          , Aa          , Ha^Fma      , Ms          , Cud         , Cud         , Cud         , Cud         , Ms          , Mm^Xm       , Aa          , Ha^Fda      , Ha^Vhha     , Aa          , Ha          , Aa          , Gg          , Gg          , Gg          , Hh          , Gg          , Hh          , Hh          , Hh          , Hh^Vc       , Hh          , Hh          , Gg          , Hh          , Mm          , Ai          , Gg          , Gg          , Mm^Vc       , Mm          , Mm          , Mm          , Hh          , Ww          , Mm          
Gg          , Gg          , Gg          , Gg          , Gg          , Gg          , Ce          , Gg          , Gg          , Re          , Re          , Gg          , Re          , Re          , Gg          , Ha^Fda      , Aa          , Mm^Xm       , Cud         , 7 Kud       , Cud         , Ha          , Ms          , Ms          , Re          , Gg          , Rd          , Ha          , Gg          , Gg          , Gg          , Gs^Fp       , Gg          , Hh          , Hh          , Hh^Fds      , Re          , Re          , Hh          , Hh^Fds      , Gg          , Gg          , Ww          , Ww          , Mm          , Ai          , Mm          , Hh          , Ww          , Ww          , Ww          , Ww          , Hh          , Ww          
Gg          , Gg          , Gg          , Gg          , Gg          , Ce          , Ce          , Ce          , Gg          , Gg          , Gg          , Re          , Gg          , Gg          , Gg          , Gg          , Ha          , Ha          , Ms          , Cud         , Aa          , Ha^Vhha     , Ha          , Aa          , Gg          , Re          , Re          , Gg          , Gg          , Hh          , Gg          , Gg          , Gg^Vc       , Gg          , Re          , Re          , Gg          , Hh          , Hh          , Gg          , Hh          , Hh          , Ww          , Hh          , Ww          , Ww          , Ww          , Ww          , Mm          , Mm          , Ha          , Ha          , Mm          , Mm          
Gg          , Gg          , Gg          , Gg          , Ce          , Ce          , 6 Ke        , Gg          , Gg          , Gg          , Gg          , Re          , Gg          , Gg          , Gg          , Gg          , Ms          , Mm^Xm       , Aa          , Ms          , Gg          , Aa          , Gg          , Gg          , Gg          , Hh^Fp       , Gg^Ve       , Re          , Re          , Gg          , Re          , Re          , Gg          , Re          , Gs^Fp       , Gg          , Gg          , Hh          , Gg          , Hh^Fms      , Ww          , Wwf         , Ww          , Ww          , Mm          , Mm          , Mm          , Mm          , Ms^Vhha     , Mm          , Mm          , Hh          , Mm          , Mm          
Re          , Re          , Re          , Gg          , Gg          , Gs^Fp       , Gg          , Gg          , Gg          , Gs^Fp       , Gg          , Re          , Gg          , Gs^Fp       , Gg          , Gg          , Gg          , Ha          , Gg          , Gg          , Gg          , Hh          , Gg          , Gg          , Hh          , Gg          , Gg          , Gg          , Re          , Re          , Re          , Gg          , Gg          , Gs^Fp       , Gg          , Gg          , Ds          , Hh^Fms      , Hh          , Ww          , Ce          , Ce          , Ce          , Hh          , Hh          , Mm          , Gg          , Ms          , Ms          , Ms          , Mm          , Mm          , Mm          , Mm          
Wo          , Gg          , Gg          , Re          , Re          , Re          , Re          , Gg          , Re          , Gg          , Re          , Re          , Re          , Re          , Re          , Re          , Re          , Re          , Re          , Re          , Re          , Re          , Re          , Gs^Fp       , Re          , Re          , Re          , Re          , Hh^Fmf      , Gg          , Gg          , Re          , Re          , Gg          , Gg          , Ds          , Ww          , Dd^Do       , Ww          , Ww          , Ce          , 2 Ke        , Ce          , Hh          , Gg          , Hh^Fp       , Mm          , Gg          , Mm          , Mm          , Mm          , Mm          , Mm          , Mm          
Ww          , Ai          , Ww          , Gg          , Gg          , Gg          , Gs^Fp       , Re          , Gg          , Re          , Gg          , Gg^Ve       , Gg          , Gg          , Gg          , Gg          , Ww          , Gg          , Gg          , Gg          , Gg          , Gg^Ve       , Gg          , Re          , Gs^Fp       , Gg          , Gg          , Gg          , Gg          , Gg          , Ds          , Gg          , Ww          , Re          , Ww^Bw\      , Ww          , Hh          , Ww          , Gg          , Hh          , Hh          , Ce          , Hh          , Hh          , Gg          , Mm          , Mm          , Mm          , Mm          , Mm          , Mm          , Mm          , Mm          , Mm          
Ww          , Ww          , Ww          , Ds          , Ds          , Gg          , Gg          , Gg          , Gg          , Gg          , Gs^Fp       , Gg          , Gs^Fp       , Gg          , Gg          , Ww          , Ww          , Ww          , Ww          , Hh          , Ww          , Gg          , Ww          , Gg          , Gg          , Gg          , Ww          , Gg          , Ds          , Ds          , Ww          , Ww          , Ww          , Ww          , Gg          , Rd          , Rd          , Hh          , Gg          , Hh          , Re          , Re          , Re          , Hh          , Hh          , Mm          , Mm^Xm       , Mm^Xm       , Re          , Hh^Vhh      , Hh          , Mm          , Re          , Mm          
Ww          , Ww          , Ww          , Ww          , Ww          , Ds          , Ww          , Ww          , Ww          , Gg          , Gg          , Gg          , Gg          , Gg          , Ww          , Ww          , Gg          , Ds          , Ds          , Ww          , Ds          , Ww          , Gg          , Ww          , Ww          , Ww          , Ww^Vm       , Ww          , Ww          , Ww          , Gg          , Gg          , Gg          , Gg          , Re          , Re          , Hh          , Rd          , Rd          , Re          , Ce          , Ce          , Ce          , Re          , Re          , Gg          , Re          , Re          , Mm          , Re          , Re          , Re          , Mm          , Re          
Ww          , Ww          , Gs^Fp       , Ww          , Ww          , Ds          , Ww          , Gs^Fp       , Ww          , Ww          , Ww          , Ww          , Ww          , Ww          , Re          , Gg          , Gg          , Gg          , Gg          , Ds          , Gg          , Gg          , Gg          , Gg          , Hh          , Gg          , Gg          , Gg          , Gg          , Gg          , Gg          , Hh^Fms      , Gg          , Gs^Fp       , Re          , Gg          , Hh          , Gg          , Gg          , Hh          , Ce          , 3 Ke        , Ce          , Hh          , Gg          , Re          , Mm          , Re          , Re          , Mm          , Mm          , Gg          , Ms          , Ms          
Gs^Fp       , Gs^Fp       , Gg          , Gs^Fp       , Gs^Fp       , Ww          , Gs^Fp       , Ww          , Gs^Fp       , Ww          , Ce          , Gs^Fp       , Gs^Fp       , Gs^Fp       , Gg          , Gs^Fp       , Hh^Fp       , Gg          , Gg          , Gs^Fp       , Gg          , Gs^Fp       , Gg          , Gg          , Gg          , Gg          , Gg          , Gg          , Gs^Fp       , Gg          , Gg          , Gg          , Gg          , Gg^Vh       , Re          , Gg          , Gg          , Hh          , Hh          , Gg          , Hh          , Ce          , Hh          , Gg          , Gg          , Mm          , Mm          , Mm          , Re          , Mm          , Mm          , Mm          , Mm          , Mm          
Gs^Fp       , Gg          , Gs^Fp       , Ss          , Gg          , Gg          , Re          , Gs^Fp       , Gs^Fp       , Ce          , 4 Ke        , Ce          , Gs^Fp       , Gg          , Ce          , Gs^Fp       , Re          , Gs^Fp       , Ss          , Gg          , Gg          , Gg          , Hh^Fms      , Gg          , Gg          , Gg          , Gg          , Gg          , Gg          , Gg          , Gs^Fp       , Hh          , Gg          , Re          , Gg          , Gg          , Gg          , Gg          , Gg          , Gg          , Hh          , Hh          , Hh          , Hh          , Hh          , Mm          , Ha^Vhha     , Re          , Mm          , Mm          , Ms          , Hh          , Mm          , Mm          
Gs^Fp       , Gg          , Gs^Fp       , Re          , Gg          , Gs^Fp       , Re          , Gs^Fp       , Gs^Fp       , Ce          , Ce          , Ce          , Gs^Fp       , Ce          , 5 Ke        , Ce          , Gs^Fp       , Gg          , Gs^Fp       , Gs^Fp       , Gs^Fp       , Gg          , Gg          , Gg          , Gg          , Hh^Fms      , Gg          , Gs^Fp       , Gg          , Gg          , Gg          , Gg          , Gg^Vh       , Re          , Gg          , Gg          , Gg          , Hh          , Re          , Gg          , Ce          , Ce          , Ce          , Hh          , Gg          , Mm          , Mm          , Mm          , Mm          , Mm          , Mm          , Mm          , Mm          , Mm          
Gs^Fp       , Hh^Fp       , Gs^Fp       , Re          , Gs^Fp       , Gg          , Gg          , Gs^Fp       , Ss          , Gs^Fp       , Gs^Fp       , Gs^Fp       , Hh^Fp       , Ce          , Ce          , Ce          , Gs^Fp       , Hh^Fp       , Re          , Ss          , Re          , Gg          , Gs^Fp       , Gg          , Gg          , Gg^Vc       , Gg          , Gg          , Gg          , Hh          , Gg          , Hh          , Gg          , Gg          , Gg          , Gg          , Hh          , Hh          , Hh^Vc       , Hh          , Ce          , 1 Ke        , Ce          , Gg          , Gg          , Hh          , Mm          , Mm^Xm       , Gg          , Mm          , Mm          , Mm^Xm       , Hh^Vc       , Mm          
Gs^Fp       , Gs^Fp       , Gg          , Hh^Fmf      , Gg^Vc       , Ss          , Gs^Fp       , Hh^Fmf      , Gs^Fp       , Re          , Gs^Fp       , Gg          , Gg          , Gs^Fp       , Gs^Fp       , Gs^Fp       , Gs^Fp       , Gs^Fp       , Gg          , Gs^Fp       , Gs^Fp       , Gs^Fp       , Gs^Fp       , Hh^Fmf      , Gs^Fp       , Gs^Fp       , Gg          , Gg          , Gg          , Gg          , Gg          , Gg          , Gg          , Gg          , Gg          , Gg          , Hh          , Gg          , Hh          , Hh          , Hh          , Ce          , Hh          , Hh          , Gg          , Re          , Re          , Mm          , Mm          , Mm          , Re          , Re          , Mm          , Mm          
Gg          , Gs^Fp       , Gg          , Gs^Fp       , Gs^Fp       , Gs^Fp       , Re          , Gs^Fp       , Ss          , Gs^Fp       , Hh^Fp       , Gg          , Gs^Fp       , Re          , Gs^Fp       , Gs^Fp       , Gg^Ve       , Ss          , Gs^Fp       , Gs^Fp       , Gs^Fp       , Re          , Hh^Fp       , Gs^Fp       , Re          , Gs^Fp       , Re          , Hh^Fp       , Gg          , Hh^Fp       , Gs^Fp       , Gg          , Gs^Fp       , Hh^Fp       , Gs^Fp       , Gg          , Gs^Fp       , Gg          , Gg          , Gg          , Gg          , Hh          , Hh          , Gg          , Hh          , Hh          , Mm          , Re          , Ms^Vhha     , Re          , Mm          , Ha          , Ha          , Mm          
Gg          , Gs^Fp       , Ss          , Gs^Fp       , Hh^Fp       , Gs^Fp       , Gs^Fp       , Gs^Fp       , Gs^Fp       , Re          , Gg^Wm       , Gs^Fp       , Gg          , Gs^Fp       , Gs^Fp       , Gg          , Re          , Gs^Fp       , Gs^Fp       , Gs^Fp       , Hh^Fmf      , Gs^Fp       , Gs^Fp       , Gs^Fp       , Gs^Fp       , Gs^Fp       , Gs^Fp       , Hh          , Gs^Fp       , Hh^Fmf      , Gg          , Gg          , Hh          , Gg          , Gs^Fp       , Gg          , Hh          , Gg          , Hh          , Hh          , Hh          , Hh          , Hh          , Hh          , Hh          , Mm          , Mm          , Mm          , Mm          , Mm          , Mm          , Ha          , Mm          , Mm          
Gs^Fp       , Gs^Fp       , Gs^Fp       , Gs^Fp       , Gs^Fp       , Gs^Fp       , Gs^Fp       , Gs^Fp       , Gs^Fp       , Gs^Fp       , Gs^Fp       , Ss          , Gs^Fp       , Gs^Fp       , Gs^Fp       , Gs^Fp       , Gs^Fp       , Gs^Fp       , Gs^Fp       , Gg          , Gs^Fp       , Gs^Fp       , Gs^Fp       , Gs^Fp       , Gs^Fp       , Gs^Fp       , Gs^Fp       , Hh^Fp       , Hh^Fp       , Hh          , Hh^Fp       , Hh^Fp       , Hh^Fp       , Hh^Fp       , Hh^Fp       , Hh^Fp       , Hh          , Hh          , Hh          , Gg          , Hh          , Gg          , Hh          , Hh          , Hh          , Mm          , Mm          , Mm          , Mm          , Ms          , Mm          , Mm          , Mm          , Mm          
