border_size=1
usage=map

Xu          , Xu          , Uu          , Xu          , Uu          , Xu          , Xu          , Xu          , Xu          , Xu          , Hh          , Ur^Ii       , Hh          , Xu          , Xu          , Xu          , Xu          , Xu          , Xu          , Xu          , Xu          , Xu          , Xu          , Uu          , Uu          , Ur^Ii       , Ur          , Xu          , Xu          , Xu          , Xu          , Xu          , Xu          , Xu          , Xu          , Xu          , Xu          , Ur^Ii       , Xu          , Xu          , Xu          , Xu          , Xu          , Xu          
Xu          , Uu          , Uu          , Uu          , Uu          , Uu          , Xu          , Xu          , Uu          , Uu          , Ur^Ii       , Ur^Ii       , Uu          , Xu          , Xu          , Xu          , Xu          , Xu          , Xu          , Xu          , Xu          , Xu          , Xu          , Xu          , Uu          , Ur^Ii       , Uu          , Xu          , Xu          , Xu          , Xu          , Xu          , Xu          , Xu          , Xu          , Xu          , Ww          , Ur^Ii       , Xu          , Xu          , Xu          , Uu          , Uu^Vu       , Xu          
Xu          , Uu          , Uu          , Uu          , Uu          , Xu          , Xu          , Uu          , Uu          , Cud         , Cud         , Cud         , Uu          , Xu          , Xu          , Xu          , Xu          , Xu          , Xu          , Xu          , Xu          , Xu          , Xu          , Uu^Vud      , Uu          , Xu          , Xu          , Uu          , Uu          , Xu          , Xu          , Xu          , Xu          , Xu          , Xu          , Xu          , Ww          , Ur^Ii       , Cud         , Cud         , 6 Kud       , Cud         , Uh          , Xu          
Xu          , Xu          , Xu          , Uu          , Uu          , Uu          , Uu          , Uu^Vud      , Uu          , Cud         , Cud         , 4 Kud       , Uu^Vu       , Xu          , Ql^Bs\      , Xu          , Uu          , Xu          , Xu          , Xu          , Xu          , Xu          , Xu          , Uu^Uf       , Cud         , Cud         , Cud         , Xu          , Ur          , Xu          , Xu          , Xu          , Xu          , Xu          , Xu          , Xu          , Xu          , Wwf         , Cud         , Cud         , Cud         , Cud         , Uu^Vu       , Xu          
Xu          , Xu          , Xu          , Xu          , Uu          , Xu          , Xu          , Uu          , Uh          , Cud         , Xu          , Xu          , Xu          , Uu^Uf       , Xu          , Ql^Bs\      , Xu          , Uu          , Uu^Uf       , Xu          , Uu          , Uu          , Qxu         , Uu          , Cud         , Cud         , Xu          , 5 Kud       , Xu          , Uu^Vu       , Xu          , Xu          , Xu          , Xu          , Xu          , Xu          , Xu          , Wwf         , Uu          , Xu          , Ur^Ii       , Uu          , Uu          , Xu          
Xu          , Xu          , Xu          , Uu          , Xu          , Xu          , Xu          , Xu          , Ur^Ii       , Ur^Ii       , Xu          , Xu          , Xu          , Uh          , Xu          , Xu          , Xu          , Xu          , Qxu         , Uu          , Qxu         , Uu          , Xu          , Uu          , Xu          , Cud         , Ur^Ii       , Xu          , Ur          , Ur          , Xu          , Xu          , Xu          , Xu          , Xu          , Xu          , Ww          , Uu^Vu       , Uu          , Xu          , Ur^Ii       , Uu          , Xu          , Xu          
Xu          , Xu          , Xu          , Uu          , Xu          , Xu          , Xu          , Xu          , Ur^Ii       , Xos         , Xu          , Xu          , Xu          , Uh          , Uh          , Xu          , Xu          , Xu          , Uu          , Uu^Vud      , Xu          , Xu          , Xu          , Uu          , Uu^Uf       , Uu^Vud      , Xu          , Ur^Ii       , Ur^Ii       , Xu          , Wwf         , Xu          , Xu          , Xu          , Xu          , Xu          , Ww          , Xu          , Ur^Ii       , Ur^Ii       , Uu          , Xu          , Xu          , Xu          
Xu          , Xu          , Xu          , Uu^Vu       , Xu          , Xu          , Xu          , Xu          , Uh          , Ur^Ii       , Ur^Ii       , Xu          , Xu          , Uu          , Uu          , Xu          , Xu          , Xu          , Xu          , Uh          , Xu          , Xu          , Xu          , Ur          , Xu          , Xu          , Xu          , Xu          , Ur^Ii       , Xu          , Ww          , Xu          , Uu          , Xu          , Uh          , Xu          , Wwf         , Uu          , Ur^Ii       , Uu          , Xu          , Xu          , Xu          , Xu          
Xu          , Xu          , Xu          , Uh          , Xu          , Xu          , Xu          , Xu          , Xu          , Uh          , Ur^Ii       , Xu          , Xu          , Uu          , Uu          , Xu          , Xu          , Xu          , Uu          , Uu          , Xu          , Xu          , Xu          , Ur          , Uu          , Xu          , Xu          , Xu          , Ur^Ii       , Xu          , Ww          , Xu          , Xu          , Uu          , Wwf         , Wwf         , Uu          , Ur^Ii       , Uu^Uf       , Uu          , Xu          , Xu          , Xu          , Xu          
Xu          , Xu          , Xu          , Uh          , Uu          , Xu          , Xu          , Xu          , Xu          , Xu          , Xos         , Ur^Ii       , Ur          , Uu^Uf       , Xu          , Xu          , Xu          , Xu          , Uu          , Xu          , Uu^Uf       , Xu          , Uu^Vu       , Ur          , Xu          , Xu          , Ur^Ii       , Ur^Ii       , Xu          , Ww          , Ww          , Xu          , Xu          , Xos         , Ww          , Xu          , Xu          , Ur^Ii       , Uu          , Xu          , Xu          , Xu          , Xu          , Xu          
Xu          , Xu          , Xu          , Xu          , Uu          , Xu          , Xu          , Uu          , Uu          , Xu          , Uu          , Ur^Ii       , Xu          , Xu          , Uu          , Xu          , Uh          , Uu          , Uu          , Uu          , Uu          , Uh          , Xu          , Ur          , Ur^Ii       , Ur^Ii       , Xu          , Uu          , Uu          , Xu          , Xu          , Ww          , Ww          , Ww          , Xu          , Xu          , Uu          , Ur^Ii       , Xu          , Xu          , Xu          , Xu          , Xu          , Xu          
Xu          , Xu          , Xu          , Xu          , Uu          , Xu          , Xu          , Xu          , Uu          , Xos         , Uu          , Ur^Ii       , Xu          , Xu          , Uu          , Uu          , Xu          , Uh          , Xu          , Xu          , Uu          , Uu          , Xu          , Xu          , Ur^Ii       , Xu          , Xu          , Ur          , Uu          , Xu          , Ww          , Ww          , Xu          , Wwf         , Xu          , Xu          , Xu          , Ur^Ii       , Xu          , Xu          , Xu          , Xu          , Xu          , Xu          
Xu          , Xu          , Xu          , Uu          , Uu          , Xu          , Xu          , Xu          , Xu          , Ur          , Xu          , Ur^Ii       , Ur^Ii       , Ur^Ii       , Ur^Ii       , Xu          , Xu          , Xu          , Uu          , Xu          , Uu          , Xu          , Xu          , Xu          , Uu          , Ur^Ii       , Ur^Ii       , Ur          , Xu          , Ww          , Xu          , Xu          , Uh          , Wwf         , Xu          , Xu          , Xu          , Ur^Ii       , Uu^Uf       , Xu          , Xu          , Xu          , Xu          , Xu          
Xu          , Xu          , Xu          , Xu          , Uu          , Xu          , Uu          , Uu^Uf       , Uh          , Uu          , Xu          , Xu          , Xu          , Uu          , Xos         , Ur^Ii       , Xu          , Xu          , Uu          , Xos         , Uh          , Xu          , Xu          , Xu          , Xu          , Xu          , Ur^Ii       , Xu          , Xu          , Xu          , Uu^Vud      , Ur          , Ww          , Xu          , Xu          , Xu          , Xu          , Ur^Ii       , Xu          , Xu          , Xu          , Xu          , Xu          , Xu          
Xu          , Xu          , Xu          , Xu          , Xu          , Uu          , Uu          , Xu          , Uh          , Uu          , Uu          , Xu          , Xu          , Xu          , Ur^Ii       , Ur^Ii       , Xu          , Xu          , Uu^Vud      , Uu          , Xu          , Xu          , Uu          , Xu          , Ur^Ii       , Ur^Ii       , Xu          , Xu          , Xu          , Uu^Uf       , Xu          , Wwf         , Ur          , Xu          , Xu          , Xu          , Ur^Ii       , Ur^Ii       , Xu          , Xu          , Xu          , Xu          , Xu          , Xu          
Xu          , Xu          , Xu          , Xu          , Xu          , Xu          , Uu          , Uu^Vu       , Xu          , Xu          , Xu          , Uu          , Uu          , Xu          , Ur^Ii       , Xos         , Uu          , Xu          , Uh          , Uu          , Xu          , Uu          , Cud         , Cud         , Ur^Ii       , Cud         , Xu          , Xu          , Xu          , Xu          , Ww          , Ww          , Xos         , Ur          , Xos         , Ur^Ii       , Xu          , Xu          , Xu          , Xu          , Xu          , Xu          , Xu          , Xu          
Xu          , Xu          , Xu          , Xu          , Xu          , Xu          , Uu          , Uu          , Xu          , Xu          , Xu          , Xu          , Uu          , Xos         , Uu          , Ur^Ii       , Uu          , Uu          , Uu          , Uu          , Xos         , Uu          , Uu          , Xu          , Ur^Ii       , Uu          , Xos         , Uu          , Uu          , Ww          , Uu^Vu       , Uu          , Xu          , Ur          , Ur          , Ur^Ii       , Uu^Vud      , Xu          , Xu          , Xu          , Xu          , Xu          , Xu          , Xu          
Xu          , Xu          , Xu          , Xu          , Xu          , Xu          , Xu          , Uu          , Xu          , Xu          , Xu          , Xu          , Uu^Vud      , Uu^Uf       , Xu          , Ur^Ii       , Uu          , Uh          , Uh          , Uu          , Uu          , Uu^Vud      , Ur          , Ur          , Ur^Ii       , Uu          , Uu          , Uu^Uf       , Ww          , Wwf         , Xu          , Xu          , Uu          , Uu          , Uu          , Ur^Ii       , Ur^Ii       , Xu          , Xu          , Xu          , Xu          , Xu          , Xu          , Xu          
Xu          , Xu          , Xu          , Xu          , Xu          , Xu          , Xu          , Uu          , Uu          , Uu          , Uu          , Xos         , Uh          , Uh          , Uh          , Ur^Ii       , Ur^Ii       , Xu          , Uu          , Uh          , Uu^Uf       , Ur          , Uu          , Ur          , Ur^Ii       , Uu          , Xu          , Xu          , Xu          , Ww          , Ww          , Uu^Uf       , Uu          , Uu          , Xu          , Xu          , Ur^Ii       , Xu          , Xu          , Xu          , Xu          , Xu          , Xu          , Xu          
Xu          , Xu          , Xu          , Xu          , Xu          , Xu          , Xu          , Xu          , Xu          , Uu          , Uu          , Uu          , Ur          , Uh          , Uu          , Uu          , Uu          , Ur^Ii       , Ur^Ii       , Uu          , Uu          , Uu          , Ur^Ii       , Ur^Ii       , Uh          , Xu          , Xu          , Xu          , Xu          , Xu          , Ww          , Xu          , Uu          , Xu          , Ur          , Ur^Ii       , Uu          , Xu          , Xu          , Xu          , Xu          , Xu          , Xu          , Xu          
Xu          , Xu          , Xu          , Xu          , Xu          , Xu          , Xu          , Xu          , Xu          , Xu          , Xu          , Uu          , Uu          , Cud         , 7 Kud       , Uu^Uf       , Uu          , Ur          , Uu          , Ur^Ii       , Ur^Ii       , Uu          , Ur^Ii       , Xu          , Xu          , Xu          , Uu          , Uu^Vu       , Ww          , Wwf         , Xu          , Xu          , Uu          , Xu          , Xu          , Ur^Ii       , Xu          , Uu          , Uh          , Xu          , Xu          , Xu          , Xu          , Xu          
Xu          , Xu          , Xu          , Xu          , Xu          , Xu          , Xu          , Xu          , Xu          , Xu          , Uu          , Uu          , Cud         , Cud         , Uu          , Uu          , Xu          , Uu          , Uu          , Uu          , Ur          , Ur^Ii       , Ur^Ii       , Uu          , Uu          , Uu          , Wwf         , Ww          , Uu          , Xu          , Xu          , Uu          , Xu          , Xu          , Xu          , Ur^Ii       , Xu          , Xu          , Uh          , Xu          , Xu          , Xu          , Xu          , Xu          
Xu          , Xu          , Xu          , Xu          , Xu          , Xu          , Xu          , Xu          , Xu          , Xu          , Uu^Vud      , Uu          , Uu          , Uu          , Uu          , Uh          , Uu          , Uu          , Uu          , Uu          , Uu          , Uu          , Uu          , Ur^Ii       , Ur^Ii       , Uu          , Wwf         , Uh          , Uu          , Xu          , Uu          , Uu          , Xu          , Xu          , Ur^Ii       , Ur^Ii       , Xu          , Xu          , Uh          , Uu          , Xu          , Xu          , Xu          , Xu          
Xu          , Xu          , Xu          , Xu          , Xu          , Xu          , Xu          , Xu          , Xu          , Uu          , Xu          , Xu          , Uu          , Uu          , Xu          , Uu^Vu       , Uu          , Xu          , Uh          , Uu          , Uu          , Uu          , Ce          , Ur^Ii       , Wwf         , Ww          , Uu          , Ww          , Wwf         , Uu          , Xu          , Xu          , Xu          , Xu          , Ur^Ii       , Uu          , Uu          , Uh          , Uu          , Uu          , Xu          , Xu          , Xu          , Xu          
Xu          , Xu          , Xu          , Xu          , Xu          , Xu          , Xu          , Xu          , Xu          , Uu          , Uu          , Uu          , Xu          , Xu          , Uu          , Uu          , Uu          , Uh          , Xu          , Xu          , Uu          , Xu          , Ce          , Ce          , Uu          , Ce          , Ce          , Uu          , Uh          , Ww          , Ww          , Xu          , Ur^Ii       , Xu          , Ur^Ii       , Uu          , Uu          , Xu          , Xu          , Xu          , Xu          , Xu          , Xu          , Xu          
Xu          , Xu          , Xu          , Xu          , Xu          , Xu          , Uu          , Xu          , Xu          , Uu          , Uu          , Xu          , Uu          , Uu^Uf       , Uu          , Xos         , Uu          , Xu          , Uu          , Uu          , Uu^Vu       , Ce          , Uu          , 1 Ke        , Uu          , Ce          , 2 Ke        , Ur^Ii       , Ur^Ii       , Uu          , Ce          , Ur^Ii       , Uu^Vud      , Ur^Ii       , Xu          , Xu          , Xu          , Uh          , Xu          , Xu          , Xu          , Xu          , Xu          , Xu          
Xu          , Xu          , Xu          , Xu          , Xu          , Xu          , Xu          , Uu          , Uh          , Uh          , Uh          , Uu          , Xu          , Xu          , Xu          , Uu          , Xu          , Uu          , Uh          , Uu          , Uh          , Uu          , Uu          , Uu          , Uu          , Ce          , Uh          , Uu          , Ce          , 3 Ke        , Ce          , Xu          , Xu          , Uu          , Xu          , Xu          , Xu          , Uh          , Uh          , Xu          , Xu          , Xu          , Xu          , Xu          
Xu          , Xu          , Xu          , Xu          , Xu          , Xu          , Xu          , Xu          , Uu          , Uu          , Xu          , Xu          , Xu          , Xu          , Xu          , Xu          , Xu          , Uh          , Uu          , Uu          , Xu          , Uh          , Uh          , Uu          , Uu          , Uu          , Xu          , Uu          , Xu          , Ce          , Xu          , Xu          , Uu          , Uu          , Xu          , Xu          , Xu          , Xu          , Xu          , Uu^Uf       , Uu          , Xu          , Xu          , Xu          
Xu          , Xu          , Xu          , Xu          , Xu          , Xu          , Xu          , Xu          , Xu          , Uu          , Xu          , Xu          , Xu          , Xu          , Xu          , Xu          , Xu          , Uu          , Xu          , Xu          , Xu          , Xu          , Xu          , Uu          , Xu          , Xu          , Xu          , Xu          , Ur          , Ur          , Ur          , Ur          , Ur          , Xu          , Xu          , Xu          , Xu          , Xu          , Xu          , Uu          , Xu          , Xu          , Xu          , Xu          
Xu          , Xu          , Xu          , Xu          , Xu          , Xu          , Xu          , Xu          , Xu          , Uu          , Uu          , Uu          , Uu          , Uu          , Xu          , Xu          , Uu          , Uu          , Uu          , Uu          , Uu          , Uu          , Uu          , Uu          , Xu          , Xu          , Xu          , Uu          , Ur          , Xu          , Xu          , Xu          , Xu          , Ur          , Xu          , Xu          , Xu          , Xu          , Xu          , Xu          , Xu          , Xu          , Xu          , Xu          
Xu          , Xu          , Xu          , Xu          , Xu          , Xu          , Xu          , Xu          , Xu          , Xu          , Xu          , Xu          , Xu          , Xu          , Xu          , Uu          , Xu          , Xu          , Xu          , Xu          , Xu          , Xu          , Uu          , Uu          , Xu          , Xu          , Xu          , Xu          , Ur          , Xu          , Xu          , Xu          , Xu          , Ur          , Ur          , Xu          , Xu          , Xu          , Xu          , Xu          , Xu          , Xu          , Xu          , Xu          
