border_size=1
usage=map

Wo          , Wo          , Wo          , Wo          , Wo          , Wo          , Wo          , Wo          , Wo          , Wo          , Wo          , Wo          , Wo          , Wo          , Wo          , Wo          , Wo          , Wo          , Wo          , Wo          , Wo          , Wo          , Wo          , Wo          , Wo          , Wo          , Wo          , Wo          , Wo          , Wo          , Wo          , Wo          
Wo          , Wo          , Wo          , Wo          , Wo          , Wo          , Wo          , Wo          , Wo          , Wo          , Wo          , Wo          , Wo          , Wo          , Ke          , Wo^Bw|      , Ke          , Wo          , Wo          , Wo          , Wo          , Wo          , Wo          , Wo          , Wo          , Wo          , Wo          , Wo          , Wo          , Wo          , Wo          , Wo          
Wo          , Wo          , Wo          , Wo          , Wo          , Wo          , Wo          , Wo          , Wo          , Wo          , Wo          , Wo          , Ce          , Ce          , Re          , Re          , Re          , Ce          , Ce          , Wo          , Wo          , Wo          , Wo          , Wo          , Wo          , Wo          , Wo          , Wo          , Wo          , Wo          , Wo          , Wo          
Wo          , Wo          , Wo          , Wo          , Wo          , Wo          , Wo          , Wo          , Wo          , Wo          , Ce          , Ce          , Re          , Re          , Re          , Re          , Re          , Re          , Re          , Ce          , Ce          , Wo          , Wo          , Wo          , Wo          , Wo          , Wo          , Wo          , Wo          , Wo          , Wo          , Wo          
Wo          , Wo          , Wo          , Wo          , Wo          , Wo          , Wo          , Wo          , Wo          , Ce          , Re          , Re          , Re          , Re          , Re          , Re          , Re          , Re          , Re          , Re          , Re          , Ce          , Wo          , Wo          , Wo          , Wo          , Wo          , Wo          , Wo          , Wo          , Wo          , Wo          
Wo          , Wo          , Wo          , Wo          , Wo          , Wo          , Wo          , Wo          , Wo          , Ce          , Re          , Re          , Re          , Re          , Rr          , Rr          , Rr          , Re          , Re          , Re          , Re          , Ce          , Wo          , Wo          , Wo          , Wo          , Wo          , Wo          , Wo          , Wo          , Wo          , Wo          
Wo          , Wo          , Wo          , Wo          , Wo          , Wo          , Wo          , Wo          , Wo          , Wo^Bw/      , Re          , Re          , Re          , Rr          , Rr          , Rr          , Rr          , Rr          , Re          , Re          , Re          , Wo^Bw\      , Wo          , Wo          , Wo          , Wo          , Wo          , Wo          , Wo          , Wo          , Wo          , Wo          
Wo          , Wo          , Wo          , Wo          , Wo          , Wo          , Wo          , Wo          , Wo          , Ce          , Re          , Re          , Re          , Rr          , Rr          , Rr          , Rr          , Rr          , Re          , Re          , Re          , Ce          , Wo          , Wo          , Wo          , Wo          , Wo          , Wo          , Wo          , Wo          , Wo          , Wo          
Wo          , Wo          , Wo          , Wo          , Wo          , Wo          , Wo          , Wo          , Wo          , Ce          , Re          , Re          , Re          , Rr          , Rr          , 2 Rr        , Rr          , Rr          , Re          , Re          , Re          , Ce          , Wo          , Wo          , Wo          , Wo          , Wo          , Wo          , Wo          , Wo          , Wo          , Wo          
Wo          , Wo          , Wo          , Wo          , Wo          , Wo          , Wo          , Wo          , Wo          , Ce          , Re          , Re          , Re          , Rr          , Rr          , Rr          , Rr          , Rr          , Re          , Re          , Re          , Ce          , Wo          , Wo          , Wo          , Wo          , Wo          , Wo          , Wo          , Wo          , Wo          , Wo          
Wo          , Wo          , Wo          , Wo          , Wo          , Wo          , Wo          , Wo          , Wo          , Ce          , Re          , Re          , Re          , Rr          , Rr          , Rr          , Rr          , Rr          , Re          , Re          , Re          , Ce          , Wo          , Wo          , Wo          , Wo          , Wo          , Wo          , Wo          , Wo          , Wo          , Wo          
Wo          , Wo          , Wo          , Wo          , Wo          , Wo          , Wo          , Wo          , Wo          , Wo^Bw/      , Re          , Re          , Re          , Re          , Re          , Rr          , Re          , Re          , Re          , Re          , Re          , Wo^Bw\      , Wo          , Wo          , Wo          , Wo          , Wo          , Wo          , Wo          , Wo          , Wo          , Wo          
Wo          , Wo          , Wo          , Wo          , Wo          , Wo          , Wo          , Wo          , Wo          , Ce          , Ce          , Re          , Re          , Re          , Re          , Re          , Re          , Re          , Re          , Re          , Ce          , Ce          , Wo          , Wo          , Wo          , Wo          , Wo          , Wo          , Wo          , Wo          , Wo          , Wo          
Wo          , Wo          , Wo          , Wo          , Wo          , Wo          , Wo          , Wo          , Wo          , Wo          , Wo          , Ce          , Ce          , Re          , Re          , Re          , Re          , Re          , Ce          , Ce          , Wo          , Wo          , Wo          , Wo          , Wo          , Wo          , Wo          , Wo          , Wo          , Wo          , Wo          , Wo          
Wo          , Wo          , Wo          , Wo          , Wo          , Wo          , Wo          , Wo          , Wo          , Wo          , Wo          , Wo          , Wo          , Ce          , Ke          , Re          , Ke          , Ce          , Wo          , Wo          , Wo          , Wo          , Wo          , Wo          , Wo          , Wo          , Wo          , Wo          , Wo          , Wo          , Wo          , Wo          
Wo          , Wo          , Wo          , Wo          , Wo          , Wo          , Wo          , Wo          , Wo^Bw|      , Wo          , Wo          , Wo          , Wo          , Wo          , Wo          , Wo^Bw|      , Wo          , Wo          , Wo          , Wo          , Wo          , Wo          , Wo          , Wo          , Wo^Bw|      , Wo          , Wo          , Wo          , Wo          , Wo          , Wo          , Wo          
Wo          , Wo          , Wo          , Wo          , Wo          , Wo          , Ce          , Ke          , Re          , Ke          , Ce          , Wo          , Wo          , Wo          , Wo          , Wo          , Wo          , Wo          , Wo          , Wo          , Wo          , Wo          , Ce          , Ke          , Re          , Ke          , Ce          , Wo          , Wo          , Wo          , Wo          , Wo          
Wo          , Wo          , Wo          , Wo          , Ce          , Ce          , Re          , Re          , Re          , Re          , Re          , Ce          , Ce          , Wo          , Wo          , Wo          , Wo          , Wo          , Wo          , Wo          , Ce          , Ce          , Re          , Re          , Re          , Re          , Re          , Ce          , Ce          , Wo          , Wo          , Wo          
Wo          , Wo          , Ce          , Ce          , Re          , Re          , Re          , Re          , Re          , Re          , Re          , Re          , Re          , Ce          , Ce          , Wo          , Wo          , Wo          , Ce          , Ce          , Re          , Re          , Re          , Re          , Re          , Re          , Re          , Re          , Re          , Ce          , Ce          , Wo          
Wo          , Wo          , Ce          , Re          , Re          , Re          , Re          , Re          , Rr          , Re          , Re          , Re          , Re          , Re          , Ce          , Wo          , Wo          , Wo          , Ce          , Re          , Re          , Re          , Re          , Re          , Rr          , Re          , Re          , Re          , Re          , Re          , Ce          , Wo          
Wo          , Wo          , Wo^Bw/      , Re          , Re          , Re          , Rr          , Rr          , Rr          , Rr          , Rr          , Re          , Re          , Re          , Wo^Bw\      , Wo          , Wo          , Wo          , Wo^Bw/      , Re          , Re          , Re          , Rr          , Rr          , Rr          , Rr          , Rr          , Re          , Re          , Re          , Wo^Bw\      , Wo          
Wo          , Wo          , Ce          , Re          , Re          , Re          , Rr          , Rr          , Rr          , Rr          , Rr          , Re          , Re          , Re          , Ce          , Wo          , Wo          , Wo          , Ce          , Re          , Re          , Re          , Rr          , Rr          , Rr          , Rr          , Rr          , Re          , Re          , Re          , Ce          , Wo          
Wo          , Wo          , Ce          , Re          , Re          , Re          , Rr          , Rr          , 3 Rr        , Rr          , Rr          , Re          , Re          , Re          , Ce          , Wo          , Wo          , Wo          , Ce          , Re          , Re          , Re          , Rr          , Rr          , 1 Rr        , Rr          , Rr          , Re          , Re          , Re          , Ce          , Wo          
Wo          , Wo          , Ce          , Re          , Re          , Re          , Rr          , Rr          , Rr          , Rr          , Rr          , Re          , Re          , Re          , Ce          , Wo          , Wo          , Wo          , Ce          , Re          , Re          , Re          , Rr          , Rr          , Rr          , Rr          , Rr          , Re          , Re          , Re          , Ce          , Wo          
Wo          , Wo          , Ce          , Re          , Re          , Re          , Rr          , Rr          , Rr          , Rr          , Rr          , Re          , Re          , Re          , Ce          , Wo          , Wo          , Wo          , Ce          , Re          , Re          , Re          , Rr          , Rr          , Rr          , Rr          , Rr          , Re          , Re          , Re          , Ce          , Wo          
Wo          , Wo          , Wo^Bw/      , Re          , Re          , Re          , Re          , Rr          , Rr          , Rr          , Re          , Re          , Re          , Re          , Wo^Bw\      , Wo          , Wo          , Wo          , Wo^Bw/      , Re          , Re          , Re          , Re          , Rr          , Rr          , Rr          , Re          , Re          , Re          , Re          , Wo^Bw\      , Wo          
Wo          , Wo          , Ce          , Re          , Re          , Re          , Re          , Re          , Re          , Re          , Re          , Re          , Re          , Re          , Ce          , Wo          , Wo          , Wo          , Ce          , Re          , Re          , Re          , Re          , Re          , Re          , Re          , Re          , Re          , Re          , Re          , Ce          , Wo          
Wo          , Wo          , Wo          , Ce          , Ce          , Re          , Re          , Re          , Re          , Re          , Re          , Re          , Ce          , Ce          , Wo          , Wo          , Wo          , Wo          , Wo          , Ce          , Ce          , Re          , Re          , Re          , Re          , Re          , Re          , Re          , Ce          , Ce          , Wo          , Wo          
Wo          , Wo          , Wo          , Wo          , Wo          , Ce          , Ce          , Re          , Re          , Re          , Ce          , Ce          , Wo          , Wo          , Wo          , Wo          , Wo          , Wo          , Wo          , Wo          , Wo          , Ce          , Ce          , Re          , Re          , Re          , Ce          , Ce          , Wo          , Wo          , Wo          , Wo          
Wo          , Wo          , Wo          , Wo          , Wo          , Wo          , Wo          , Ke          , Wo^Bw|      , Ke          , Wo          , Wo          , Wo          , Wo          , Wo          , Wo          , Wo          , Wo          , Wo          , Wo          , Wo          , Wo          , Wo          , Ke          , Wo^Bw|      , Ke          , Wo          , Wo          , Wo          , Wo          , Wo          , Wo          
Wo          , Wo          , Wo          , Wo          , Wo          , Wo          , Wo          , Wo          , Wo          , Wo          , Wo          , Wo          , Wo          , Wo          , Wo          , Wo          , Wo          , Wo          , Wo          , Wo          , Wo          , Wo          , Wo          , Wo          , Wo          , Wo          , Wo          , Wo          , Wo          , Wo          , Wo          , Wo          
Wo          , Wo          , Wo          , Wo          , Wo          , Wo          , Wo          , Wo          , Wo          , Wo          , Wo          , Wo          , Wo          , Wo          , Wo          , Wo          , Wo          , Wo          , Wo          , Wo          , Wo          , Wo          , Wo          , Wo          , Wo          , Wo          , Wo          , Wo          , Wo          , Wo          , Wo          , Wo          
